,level,page_num,block_num,par_num,line_num,word_num,left,top,width,height,conf,text,pdf_page,bottom,right
0,1,1,0,0,0,0,0,0,3106,3853,-1,,1,3853,3106
1,2,1,1,0,0,0,0,51,2832,3802,-1,,1,3853,2832
2,3,1,1,1,0,0,0,51,2832,3802,-1,,1,3853,2832
3,4,1,1,1,1,0,2210,51,622,45,-1,,1,96,2832
4,5,1,1,1,1,1,2210,51,225,37,91,Castlemore,1,88,2435
5,5,1,1,1,1,2,2451,53,141,43,96,Ranger,1,96,2592
6,5,1,1,1,1,3,2605,53,57,41,95,(3),1,94,2662
7,5,1,1,1,1,4,2678,51,154,35,93,Limited,1,86,2832
8,4,1,1,1,2,0,2012,112,820,47,-1,,1,159,2832
9,5,1,1,1,2,1,2012,112,188,37,93,Directors,1,149,2200
10,5,1,1,1,2,2,2219,120,116,39,96,report,1,159,2335
11,5,1,1,1,2,3,2351,114,70,35,96,and,1,149,2421
12,5,1,1,1,2,4,2437,114,170,35,95,financial,1,149,2607
13,5,1,1,1,2,5,2625,119,207,30,96,statements,1,149,2832
14,4,1,1,1,3,0,2063,168,769,47,-1,,1,215,2832
15,5,1,1,1,3,1,2063,170,70,36,96,For,1,206,2133
16,5,1,1,1,3,2,2147,171,53,35,96,the,1,206,2200
17,5,1,1,1,3,3,2214,180,84,35,96,year,1,215,2298
18,5,1,1,1,3,4,2310,171,117,35,95,ended,1,206,2427
19,5,1,1,1,3,5,2445,170,47,36,96,30,1,206,2492
20,5,1,1,1,3,6,2509,170,212,45,96,September,1,215,2721
21,5,1,1,1,3,7,2735,168,97,36,96,2007,1,204,2832
22,4,1,1,1,4,0,245,325,696,51,-1,,1,376,941
23,5,1,1,1,4,1,245,325,176,51,96,Profit,1,376,421
24,5,1,1,1,4,2,441,327,110,49,95,and,1,376,551
25,5,1,1,1,4,3,574,327,110,49,96,loss,1,376,684
26,5,1,1,1,4,4,704,331,237,45,96,account,1,376,941
27,4,1,1,1,5,0,234,401,857,53,-1,,1,454,1091
28,5,1,1,1,5,1,234,403,76,49,95,for,1,452,310
29,5,1,1,1,5,2,322,403,64,40,96,the,1,443,386
30,5,1,1,1,5,3,400,417,102,37,95,year,1,454,502
31,5,1,1,1,5,4,515,401,134,42,95,ended,1,443,649
32,5,1,1,1,5,5,661,401,56,40,96,30,1,441,717
33,5,1,1,1,5,6,731,403,235,49,96,September,1,452,966
34,5,1,1,1,5,7,980,403,111,40,96,2007,1,443,1091
35,4,1,1,1,6,0,1911,558,881,57,-1,,1,615,2792
36,5,1,1,1,6,1,1911,560,91,55,96,Note,1,615,2002
37,5,1,1,1,6,2,2298,566,98,35,96,2007,1,601,2396
38,5,1,1,1,6,3,2693,558,99,56,96,2006,1,614,2792
39,4,1,1,1,7,0,2374,621,419,37,-1,,1,658,2793
40,5,1,1,1,7,1,2374,623,22,35,92,£,1,658,2396
41,5,1,1,1,7,2,2768,621,25,35,91,£,1,656,2793
42,4,1,1,1,8,0,245,734,2540,56,-1,,1,790,2785
43,5,1,1,1,8,1,245,734,194,56,95,Turnover,1,790,439
44,5,1,1,1,8,2,1983,737,15,37,61,i,1,774,1998
45,5,1,1,1,8,3,2382,758,14,6,92,-,1,764,2396
46,5,1,1,1,8,4,2590,736,195,39,0,5656111,1,775,2785
47,4,1,1,1,9,0,245,795,2564,43,-1,,1,838,2809
48,5,1,1,1,9,1,245,797,86,35,96,Cost,1,832,331
49,5,1,1,1,9,2,345,797,41,35,96,of,1,832,386
50,5,1,1,1,9,3,396,799,90,35,96,sales,1,834,486
51,5,1,1,1,9,4,2382,817,14,7,86,-,1,824,2396
52,5,1,1,1,9,5,2574,795,235,43,0,(4834393),1,838,2809
53,4,1,1,1,10,0,245,946,2546,49,-1,,1,995,2791
54,5,1,1,1,10,1,245,950,118,37,96,Gross,1,987,363
55,5,1,1,1,10,2,376,952,114,43,96,profit,1,995,490
56,5,1,1,1,10,3,2382,967,14,8,48,-,1,975,2396
57,5,1,1,1,10,4,2629,948,66,35,90,821,1,983,2695
58,5,1,1,1,10,5,2719,946,72,35,90,718,1,981,2791
59,4,1,1,1,11,0,245,1062,2564,52,-1,,1,1114,2809
60,5,1,1,1,11,1,245,1067,284,36,29,Admunuistrative,1,1103,529
61,5,1,1,1,11,2,543,1077,172,37,96,expenses,1,1114,715
62,5,1,1,1,11,3,2241,1062,172,51,0,(55985),1,1113,2413
63,5,1,1,1,11,4,2637,1065,62,43,95,(25,1,1108,2699
64,5,1,1,1,11,5,2717,1063,92,42,96,693),1,1105,2809
65,4,1,1,1,12,0,243,1122,2540,51,-1,,1,1173,2783
66,5,1,1,1,12,1,243,1126,110,35,96,Other,1,1161,353
67,5,1,1,1,12,2,365,1135,182,38,96,operating,1,1173,547
68,5,1,1,1,12,3,561,1136,139,25,92,income,1,1161,700
69,5,1,1,1,12,4,1981,1126,15,35,61,/,1,1161,1996
70,5,1,1,1,12,5,2326,1126,70,35,94,138,1,1161,2396
71,5,1,1,1,12,6,2633,1124,68,35,92,124,1,1159,2701
72,5,1,1,1,12,7,2717,1122,66,37,92,901,1,1159,2783
73,4,1,1,1,13,0,245,1273,2548,54,-1,,1,1327,2793
74,5,1,1,1,13,1,245,1279,208,45,93,Operating,1,1324,453
75,5,1,1,1,13,2,467,1279,236,45,87,(loss)/profit,1,1324,703
76,5,1,1,1,13,3,2243,1273,170,54,0,(55847),1,1327,2413
77,5,1,1,1,13,4,2629,1275,164,37,0,920926,1,1312,2793
78,4,1,1,1,14,0,245,1392,2546,45,-1,,1,1437,2791
79,5,1,1,1,14,1,245,1396,110,36,96,Other,1,1432,355
80,5,1,1,1,14,2,367,1403,138,29,96,interest,1,1432,505
81,5,1,1,1,14,3,520,1395,195,37,22,receivable,1,1432,715
82,5,1,1,1,14,4,729,1396,68,34,96,and,1,1430,797
83,5,1,1,1,14,5,811,1396,133,34,67,simular,1,1430,944
84,5,1,1,1,14,6,957,1406,138,24,96,income,1,1430,1095
85,5,1,1,1,14,7,1979,1393,21,37,96,4,1,1430,2000
86,5,1,1,1,14,8,2259,1394,131,43,0,78036,1,1437,2390
87,5,1,1,1,14,9,2629,1392,162,38,0,353905,1,1430,2791
88,4,1,1,1,15,0,247,1448,2562,54,-1,,1,1502,2809
89,5,1,1,1,15,1,247,1455,138,35,96,Interest,1,1490,385
90,5,1,1,1,15,2,400,1455,148,45,96,payable,1,1500,548
91,5,1,1,1,15,3,563,1453,66,37,96,and,1,1490,629
92,5,1,1,1,15,4,645,1454,131,34,68,simular,1,1488,776
93,5,1,1,1,15,5,788,1455,145,43,96,charges,1,1498,933
94,5,1,1,1,15,6,1979,1452,23,36,96,5,1,1488,2002
95,5,1,1,1,15,7,2306,1448,107,54,95,(284),1,1502,2413
96,5,1,1,1,15,8,2639,1451,170,43,0,(72534),1,1494,2809
97,4,1,1,1,16,0,246,1602,2545,51,-1,,1,1653,2791
98,5,1,1,1,16,1,246,1608,116,35,96,Profit,1,1643,362
99,5,1,1,1,16,2,376,1618,49,25,96,on,1,1643,425
100,5,1,1,1,16,3,437,1608,180,45,96,ordinary,1,1653,617
101,5,1,1,1,16,4,631,1612,180,29,76,activities,1,1641,811
102,5,1,1,1,16,5,825,1606,127,35,96,before,1,1641,952
103,5,1,1,1,16,6,968,1608,164,33,96,taxation,1,1641,1132
104,5,1,1,1,16,7,1979,1606,21,33,96,2,1,1639,2000
105,5,1,1,1,16,8,2259,1604,137,43,0,21905,1,1647,2396
106,5,1,1,1,16,9,2596,1602,195,43,0,1202297,1,1645,2791
107,4,1,1,1,17,0,243,1717,2566,53,-1,,1,1770,2809
108,5,1,1,1,17,1,243,1723,73,36,96,Tax,1,1759,316
109,5,1,1,1,17,2,331,1733,45,26,96,on,1,1759,376
110,5,1,1,1,17,3,391,1723,104,45,96,profit,1,1768,495
111,5,1,1,1,17,4,510,1735,46,24,96,on,1,1759,556
112,5,1,1,1,17,5,570,1723,163,45,96,ordinary,1,1768,733
113,5,1,1,1,17,6,747,1730,170,29,86,activities,1,1759,917
114,5,1,1,1,17,7,1979,1723,21,36,96,6,1,1759,2000
115,5,1,1,1,17,8,2266,1717,147,53,0,(6572),1,1770,2413
116,5,1,1,1,17,9,2613,1721,80,43,19,(941,1,1764,2693
117,5,1,1,1,17,10,2707,1719,102,44,0,630),1,1763,2809
118,4,1,1,1,18,0,0,1836,2789,128,-1,,1,1964,2789
119,5,1,1,1,18,1,0,1836,30,128,0,l,1,1964,30
120,5,1,1,1,18,2,245,1876,118,35,95,Profit,1,1911,363
121,5,1,1,1,18,3,376,1876,59,35,96,for,1,1911,435
122,5,1,1,1,18,4,449,1876,61,35,96,the,1,1911,510
123,5,1,1,1,18,5,525,1876,175,35,96,financial,1,1911,700
124,5,1,1,1,18,6,713,1886,90,33,96,year,1,1919,803
125,5,1,1,1,18,7,1959,1874,39,35,59,if,1,1909,1998
126,5,1,1,1,18,8,2263,1874,131,42,0,15333,1,1916,2394
127,5,1,1,1,18,9,2629,1872,74,35,96,260,1,1907,2703
128,5,1,1,1,18,10,2717,1872,72,35,96,667,1,1907,2789
129,4,1,1,1,19,0,246,2062,1137,51,-1,,1,2113,1383
130,5,1,1,1,19,1,246,2064,65,37,95,All,1,2101,311
131,5,1,1,1,19,2,329,2072,181,31,96,amounts,1,2103,510
132,5,1,1,1,19,3,527,2076,65,27,95,are,1,2103,592
133,5,1,1,1,19,4,608,2062,163,39,96,derived,1,2101,771
134,5,1,1,1,19,5,790,2062,102,39,96,from,1,2101,892
135,5,1,1,1,19,6,909,2071,231,42,96,continuing,1,2113,1140
136,5,1,1,1,19,7,1156,2072,227,41,95,operations,1,2113,1383
137,4,1,1,1,20,0,245,2158,2581,55,-1,,1,2213,2826
138,5,1,1,1,20,1,245,2163,84,38,96,The,1,2201,329
139,5,1,1,1,20,2,347,2176,198,37,96,company,1,2213,545
140,5,1,1,1,20,3,564,2164,69,37,96,has,1,2201,633
141,5,1,1,1,20,4,653,2174,52,25,96,no,1,2199,705
142,5,1,1,1,20,5,724,2162,234,49,96,recognised,1,2211,958
143,5,1,1,1,20,6,978,2174,113,37,82,gains,1,2211,1091
144,5,1,1,1,20,7,1109,2174,45,26,96,or,1,2200,1154
145,5,1,1,1,20,8,1172,2162,127,39,96,losses,1,2201,1299
146,5,1,1,1,20,9,1320,2172,37,27,84,in,1,2199,1357
147,5,1,1,1,20,10,1377,2160,61,39,96,the,1,2199,1438
148,5,1,1,1,20,11,1458,2170,152,29,96,current,1,2199,1610
149,5,1,1,1,20,12,1628,2173,45,26,96,or,1,2199,1673
150,5,1,1,1,20,13,1693,2162,215,49,96,preceding,1,2211,1908
151,5,1,1,1,20,14,1928,2172,89,39,96,year,1,2211,2017
152,5,1,1,1,20,15,2035,2160,114,39,96,other,1,2199,2149
153,5,1,1,1,20,16,2167,2160,83,37,95,than,1,2197,2250
154,5,1,1,1,20,17,2268,2160,114,39,95,those,1,2199,2382
155,5,1,1,1,20,18,2404,2160,138,39,96,shown,1,2199,2542
156,5,1,1,1,20,19,2563,2172,36,27,38,tn,1,2199,2599
157,5,1,1,1,20,20,2621,2160,63,39,96,the,1,2199,2684
158,5,1,1,1,20,21,2703,2158,123,51,96,profit,1,2209,2826
159,4,1,1,1,21,0,245,2227,360,39,-1,,1,2266,605
160,5,1,1,1,21,1,245,2227,76,39,96,and,1,2266,321
161,5,1,1,1,21,2,340,2227,81,39,96,loss,1,2266,421
162,5,1,1,1,21,3,437,2236,168,30,96,account,1,2266,605
163,4,1,1,1,22,0,0,3829,24,24,-1,,1,3853,24
164,5,1,1,1,22,1,0,3829,24,24,12,-,1,3853,24
0,1,1,0,0,0,0,0,0,3106,3853,-1,,2,3853,3106
1,2,1,1,0,0,0,0,51,2836,3802,-1,,2,3853,2836
2,3,1,1,1,0,0,0,51,2836,3802,-1,,2,3853,2836
3,4,1,1,1,1,0,2210,51,625,45,-1,,2,96,2835
4,5,1,1,1,1,1,2210,51,228,35,92,Castlemore,2,86,2438
5,5,1,1,1,1,2,2454,52,141,44,96,Ranger,2,96,2595
6,5,1,1,1,1,3,2608,51,57,43,95,(3),2,94,2665
7,5,1,1,1,1,4,2682,53,153,33,94,Limited,2,86,2835
8,4,1,1,1,2,0,2012,114,824,45,-1,,2,159,2836
9,5,1,1,1,2,1,2012,114,191,35,92,Directors,2,149,2203
10,5,1,1,1,2,2,2220,120,120,39,96,report,2,159,2340
11,5,1,1,1,2,3,2356,114,68,35,96,and,2,149,2424
12,5,1,1,1,2,4,2442,114,168,35,93,financial,2,149,2610
13,5,1,1,1,2,5,2628,120,208,29,96,statements,2,149,2836
14,4,1,1,1,3,0,2066,171,768,45,-1,,2,216,2834
15,5,1,1,1,3,1,2066,171,68,35,96,For,2,206,2134
16,5,1,1,1,3,2,2146,171,56,35,96,the,2,206,2202
17,5,1,1,1,3,3,2215,181,86,35,96,year,2,216,2301
18,5,1,1,1,3,4,2312,171,118,35,95,ended,2,206,2430
19,5,1,1,1,3,5,2448,171,47,35,95,30,2,206,2495
20,5,1,1,1,3,6,2510,171,214,45,95,September,2,216,2724
21,5,1,1,1,3,7,2738,171,96,35,95,2007,2,206,2834
22,4,1,1,1,4,0,246,322,413,51,-1,,2,373,659
23,5,1,1,1,4,1,246,322,239,51,95,Balance,2,373,485
24,5,1,1,1,4,2,506,324,153,49,95,sheet,2,373,659
25,4,1,1,1,5,0,244,400,486,51,-1,,2,451,730
26,5,1,1,1,5,1,244,410,42,29,96,at,2,439,286
27,5,1,1,1,5,2,301,400,54,39,96,30,2,439,355
28,5,1,1,1,5,3,371,400,235,51,96,September,2,451,606
29,5,1,1,1,5,4,620,400,110,39,96,2007,2,439,730
30,4,1,1,1,6,0,1895,561,900,52,-1,,2,613,2795
31,5,1,1,1,6,1,1895,561,109,52,96,Note,2,613,2004
32,5,1,1,1,6,2,2299,565,96,35,96,2007,2,600,2395
33,5,1,1,1,6,3,2695,561,100,52,96,2006,2,613,2795
34,4,1,1,1,7,0,2371,622,418,37,-1,,2,659,2789
35,5,1,1,1,7,1,2371,624,22,35,89,£,2,659,2393
36,5,1,1,1,7,2,2765,622,24,35,93,£,2,657,2789
37,4,1,1,1,8,0,246,679,293,37,-1,,2,716,539
38,5,1,1,1,8,1,246,679,164,36,95,Current,2,715,410
39,5,1,1,1,8,2,422,685,117,31,96,assets,2,716,539
40,4,1,1,1,9,0,246,732,2543,56,-1,,2,788,2789
41,5,1,1,1,9,1,246,732,122,56,96,Stocks,2,788,368
42,5,1,1,1,9,2,1985,739,23,34,95,7,2,773,2008
43,5,1,1,1,9,3,2230,739,164,44,0,230554,2,783,2394
44,5,1,1,1,9,4,2652,739,137,37,0,30137,2,776,2789
45,4,1,1,1,10,0,232,791,2557,56,-1,,2,847,2789
46,5,1,1,1,10,1,232,791,160,56,96,Debtors,2,847,392
47,5,1,1,1,10,2,1981,798,25,36,95,8,2,834,2006
48,5,1,1,1,10,3,2198,798,197,43,0,1089550,2,841,2395
49,5,1,1,1,10,4,2593,798,196,38,0,1273116,2,836,2789
50,4,1,1,1,11,0,2197,945,590,56,-1,,2,1001,2787
51,5,1,1,1,11,1,2197,945,196,56,0,1320104,2,1001,2393
52,5,1,1,1,11,2,2593,951,10,34,64,1,2,985,2603
53,5,1,1,1,11,3,2626,949,161,39,0,303253,2,988,2787
54,4,1,1,1,12,0,244,1062,2561,52,-1,,2,1114,2805
55,5,1,1,1,12,1,244,1065,213,35,0,Creditors,2,1100,457
56,5,1,1,1,12,2,476,1067,179,33,95,Amounts,2,1100,655
57,5,1,1,1,12,3,672,1065,125,47,96,falling,2,1112,797
58,5,1,1,1,12,4,810,1067,69,35,96,due,2,1102,879
59,5,1,1,1,12,5,897,1067,121,33,96,within,2,1100,1018
60,5,1,1,1,12,6,1034,1077,70,25,95,one,2,1102,1104
61,5,1,1,1,12,7,1120,1077,84,33,96,year,2,1110,1204
62,5,1,1,1,12,8,1982,1065,23,35,96,9,2,1100,2005
63,5,1,1,1,12,9,2238,1062,170,52,0,(86906),2,1114,2408
64,5,1,1,1,12,10,2634,1065,63,41,57,(85S,2,1106,2697
65,5,1,1,1,12,11,2714,1065,91,43,94,388),2,1108,2805
66,4,1,1,1,13,0,242,1216,2545,45,-1,,2,1261,2787
67,5,1,1,1,13,1,242,1216,72,37,96,Net,2,1253,314
68,5,1,1,1,13,2,328,1222,157,31,96,current,2,1253,485
69,5,1,1,1,13,3,501,1223,119,30,96,assets,2,1253,620
70,5,1,1,1,13,4,636,1218,74,35,96,and,2,1253,710
71,5,1,1,1,13,5,727,1222,62,31,96,net,2,1253,789
72,5,1,1,1,13,6,803,1222,117,31,95,assets,2,1253,920
73,5,1,1,1,13,7,2199,1218,192,43,0,1233198,2,1261,2391
74,5,1,1,1,13,8,2593,1218,9,33,62,1,2,1251,2602
75,5,1,1,1,13,9,2626,1216,161,38,0,217865,2,1254,2787
76,4,1,1,1,14,0,244,1367,417,45,-1,,2,1412,661
77,5,1,1,1,14,1,244,1367,147,45,95,Capital,2,1412,391
78,5,1,1,1,14,2,406,1369,75,33,96,and,2,1402,481
79,5,1,1,1,14,3,497,1379,164,25,90,reserves,2,1404,661
80,4,1,1,1,15,0,242,1421,2545,54,-1,,2,1475,2787
81,5,1,1,1,15,1,242,1426,123,35,95,Called,2,1461,365
82,5,1,1,1,15,2,381,1436,47,35,95,up,2,1471,428
83,5,1,1,1,15,3,442,1426,100,35,96,share,2,1461,542
84,5,1,1,1,15,4,555,1426,124,45,94,capital,2,1471,679
85,5,1,1,1,15,5,1961,1426,44,35,92,10,2,1461,2005
86,5,1,1,1,15,6,2318,1428,73,35,94,900,2,1463,2391
87,5,1,1,1,15,7,2714,1421,73,54,96,900,2,1475,2787
88,4,1,1,1,16,0,244,1485,2542,45,-1,,2,1530,2786
89,5,1,1,1,16,1,244,1485,105,35,96,Profit,2,1520,349
90,5,1,1,1,16,2,365,1485,67,35,96,and,2,1520,432
91,5,1,1,1,16,3,448,1485,72,35,96,loss,2,1520,520
92,5,1,1,1,16,4,534,1491,149,29,95,account,2,1520,683
93,5,1,1,1,16,5,1961,1485,37,35,0,tT,2,1520,1998
94,5,1,1,1,16,6,2200,1487,193,43,0,1232298,2,1530,2393
95,5,1,1,1,16,7,2593,1487,8,33,79,1,2,1520,2601
96,5,1,1,1,16,8,2626,1485,160,35,84,216965,2,1520,2786
97,4,1,1,1,17,0,242,1636,2543,45,-1,,2,1681,2785
98,5,1,1,1,17,1,242,1638,284,35,92,Shareholders,2,1673,526
99,5,1,1,1,17,2,542,1638,113,35,96,funds,2,1673,655
100,5,1,1,1,17,3,2200,1638,193,43,0,1233198,2,1681,2393
101,5,1,1,1,17,4,2593,1638,9,33,80,1,2,1671,2602
102,5,1,1,1,17,5,2626,1636,159,39,0,217865,2,1675,2785
103,4,1,1,1,18,0,242,1855,2586,49,-1,,2,1904,2828
104,5,1,1,1,18,1,242,1855,128,39,96,These,2,1894,370
105,5,1,1,1,18,2,391,1855,187,39,95,financial,2,1894,578
106,5,1,1,1,18,3,599,1863,225,31,96,statements,2,1894,824
107,5,1,1,1,18,4,844,1867,102,27,96,were,2,1894,946
108,5,1,1,1,18,5,965,1855,201,49,96,approved,2,1904,1166
109,5,1,1,1,18,6,1185,1855,53,49,96,by,2,1904,1238
110,5,1,1,1,18,7,1257,1855,62,37,96,the,2,1892,1319
111,5,1,1,1,18,8,1340,1855,120,39,96,board,2,1894,1460
112,5,1,1,1,18,9,1481,1855,49,39,96,of,2,1894,1530
113,5,1,1,1,18,10,1542,1855,190,39,96,directors,2,1894,1732
114,5,1,1,1,18,11,1750,1867,51,27,94,on,2,1894,1801
115,5,1,1,1,18,12,1820,1855,44,39,86,31,2,1894,1864
116,5,1,1,1,18,13,1891,1855,140,39,96,March,2,1894,2031
117,5,1,1,1,18,14,2048,1855,109,39,96,2008,2,1894,2157
118,5,1,1,1,18,15,2179,1855,69,39,96,and,2,1894,2248
119,5,1,1,1,18,16,2267,1867,104,27,95,were,2,1894,2371
120,5,1,1,1,18,17,2391,1855,139,49,95,signed,2,1904,2530
121,5,1,1,1,18,18,2550,1867,50,27,94,on,2,1894,2600
122,5,1,1,1,18,19,2621,1864,47,30,59,its,2,1894,2668
123,5,1,1,1,18,20,2687,1855,141,39,95,behalf,2,1894,2828
124,4,1,1,1,19,0,242,1920,52,49,-1,,2,1969,294
125,5,1,1,1,19,1,242,1920,52,49,97,by,2,1969,294
126,4,1,1,1,20,0,242,2316,270,39,-1,,2,2355,512
127,5,1,1,1,20,1,242,2316,78,39,92,GA,2,2355,320
128,5,1,1,1,20,2,338,2316,174,39,56,Credalh,2,2355,512
129,4,1,1,1,21,0,240,2381,187,37,-1,,2,2418,427
130,5,1,1,1,21,1,240,2381,187,37,96,Director,2,2418,427
131,4,1,1,1,22,0,0,3830,18,23,-1,,2,3853,18
132,5,1,1,1,22,1,0,3830,18,23,23,a,2,3853,18
0,1,1,0,0,0,0,0,0,3106,3853,-1,,3,3853,3106
1,2,1,1,0,0,0,0,57,2840,3796,-1,,3,3853,2840
2,3,1,1,1,0,0,0,57,2840,3796,-1,,3,3853,2840
3,4,1,1,1,1,0,2215,57,625,45,-1,,3,102,2840
4,5,1,1,1,1,1,2215,57,227,35,92,Castlemore,3,92,2442
5,5,1,1,1,1,2,2459,57,141,45,96,Ranger,3,102,2600
6,5,1,1,1,1,3,2615,57,55,41,95,(3),3,98,2670
7,5,1,1,1,1,4,2686,57,154,35,93,Limited,3,92,2840
8,4,1,1,1,2,0,2017,118,823,45,-1,,3,163,2840
9,5,1,1,1,2,1,2017,118,190,35,92,Directors,3,153,2207
10,5,1,1,1,2,2,2225,126,119,37,95,report,3,163,2344
11,5,1,1,1,2,3,2360,120,69,33,95,and,3,153,2429
12,5,1,1,1,2,4,2446,118,171,35,96,financial,3,153,2617
13,5,1,1,1,2,5,2632,126,208,29,96,statements,3,155,2840
14,4,1,1,1,3,0,2070,175,768,47,-1,,3,222,2838
15,5,1,1,1,3,1,2070,175,68,35,96,For,3,210,2138
16,5,1,1,1,3,2,2150,176,57,36,96,the,3,212,2207
17,5,1,1,1,3,3,2219,186,85,34,96,year,3,220,2304
18,5,1,1,1,3,4,2317,176,117,36,96,ended,3,212,2434
19,5,1,1,1,3,5,2452,176,49,36,96,30,3,212,2501
20,5,1,1,1,3,6,2517,175,211,47,96,September,3,222,2728
21,5,1,1,1,3,7,2744,176,94,36,95,2007,3,212,2838
22,4,1,1,1,4,0,251,325,1574,53,-1,,3,378,1825
23,5,1,1,1,4,1,251,325,435,51,95,Reconciliation,3,376,686
24,5,1,1,1,4,2,708,327,62,51,96,of,3,378,770
25,5,1,1,1,4,3,785,333,338,45,96,movements,3,378,1123
26,5,1,1,1,4,4,1145,327,56,51,92,in,3,378,1201
27,5,1,1,1,4,5,1223,327,412,51,91,shareholders,3,378,1635
28,5,1,1,1,4,6,1659,327,166,51,95,funds,3,378,1825
29,4,1,1,1,5,0,240,404,855,51,-1,,3,455,1095
30,5,1,1,1,5,1,240,404,74,50,94,for,3,454,314
31,5,1,1,1,5,2,328,404,64,39,96,the,3,443,392
32,5,1,1,1,5,3,406,418,104,36,92,year,3,454,510
33,5,1,1,1,5,4,522,404,133,39,95,ended,3,443,655
34,5,1,1,1,5,5,669,404,55,39,95,30,3,443,724
35,5,1,1,1,5,6,739,406,233,49,96,September,3,455,972
36,5,1,1,1,5,7,985,406,110,39,96,2007,3,445,1095
37,4,1,1,1,6,0,2303,563,494,56,-1,,3,619,2797
38,5,1,1,1,6,1,2303,570,98,36,96,2007,3,606,2401
39,5,1,1,1,6,2,2699,563,98,56,96,2006,3,619,2797
40,4,1,1,1,7,0,2380,627,416,36,-1,,3,663,2796
41,5,1,1,1,7,1,2380,627,21,36,91,£,3,663,2401
42,5,1,1,1,7,2,2774,627,22,36,92,£,3,663,2796
43,4,1,1,1,8,0,0,737,2803,126,-1,,3,863,2803
44,5,1,1,1,8,1,0,737,30,126,0,j,3,863,30
45,5,1,1,1,8,2,251,741,119,35,96,Profit,3,776,370
46,5,1,1,1,8,3,387,741,60,35,96,for,3,776,447
47,5,1,1,1,8,4,461,741,65,35,96,the,3,776,526
48,5,1,1,1,8,5,540,741,181,35,96,financial,3,776,721
49,5,1,1,1,8,6,735,753,94,33,96,year,3,786,829
50,5,1,1,1,8,7,2274,743,133,43,0,15333,3,786,2407
51,5,1,1,1,8,8,2642,743,161,36,0,260667,3,779,2803
52,4,1,1,1,9,0,250,892,2553,45,-1,,3,937,2803
53,5,1,1,1,9,1,250,892,70,35,96,Net,3,927,320
54,5,1,1,1,9,2,334,892,174,35,90,addition,3,927,508
55,5,1,1,1,9,3,524,897,39,30,91,to,3,927,563
56,5,1,1,1,9,4,577,892,284,37,72,shareholders,3,929,861
57,5,1,1,1,9,5,878,894,114,33,96,funds,3,927,992
58,5,1,1,1,9,6,2274,894,133,43,0,15333,3,937,2407
59,5,1,1,1,9,7,2642,892,161,39,0,260667,3,931,2803
60,4,1,1,1,10,0,248,1006,2555,46,-1,,3,1052,2803
61,5,1,1,1,10,1,248,1006,170,45,96,Opening,3,1051,418
62,5,1,1,1,10,2,432,1008,264,35,0,shareholders,3,1043,696
63,5,1,1,1,10,3,716,1008,108,35,96,funds,3,1043,824
64,5,1,1,1,10,4,2212,1010,195,42,0,1217865,3,1052,2407
65,5,1,1,1,10,5,2640,1008,73,36,95,957,3,1044,2713
66,5,1,1,1,10,6,2736,1008,67,35,95,198,3,1043,2803
67,4,1,1,1,11,0,249,1155,2552,56,-1,,3,1211,2801
68,5,1,1,1,11,1,249,1157,151,46,93,Closing,3,1203,400
69,5,1,1,1,11,2,414,1158,278,36,92,shareholders,3,1194,692
70,5,1,1,1,11,3,708,1158,112,36,96,funds,3,1194,820
71,5,1,1,1,11,4,2212,1155,195,56,0,1233198,3,1211,2407
72,5,1,1,1,11,5,2609,1160,8,34,71,1,3,1194,2617
73,5,1,1,1,11,6,2641,1158,72,36,94,217,3,1194,2713
74,5,1,1,1,11,7,2730,1158,71,36,95,865,3,1194,2801
75,4,1,1,1,12,0,0,3832,22,21,-1,,3,3853,22
76,5,1,1,1,12,1,0,3832,22,21,0,-,3,3853,22
0,1,1,0,0,0,0,0,0,3106,3853,-1,,4,3853,3106
1,2,1,1,0,0,0,0,55,2838,3798,-1,,4,3853,2838
2,3,1,1,1,0,0,0,55,2838,3798,-1,,4,3853,2838
3,4,1,1,1,1,0,2214,55,624,45,-1,,4,100,2838
4,5,1,1,1,1,1,2214,55,227,35,91,Castlemore,4,90,2441
5,5,1,1,1,1,2,2457,55,140,45,96,Ranger,4,100,2597
6,5,1,1,1,1,3,2613,55,55,41,93,(3),4,96,2668
7,5,1,1,1,1,4,2686,55,152,35,51,Limuted,4,90,2838
8,4,1,1,1,2,0,2018,116,820,45,-1,,4,161,2838
9,5,1,1,1,2,1,2018,116,188,35,87,Directors,4,151,2206
10,5,1,1,1,2,2,2223,124,119,37,96,report,4,161,2342
11,5,1,1,1,2,3,2357,117,70,34,96,and,4,151,2427
12,5,1,1,1,2,4,2445,116,170,35,92,financial,4,151,2615
13,5,1,1,1,2,5,2631,123,207,28,96,statements,4,151,2838
14,4,1,1,1,3,0,2071,173,765,44,-1,,4,217,2836
15,5,1,1,1,3,1,2071,174,66,34,96,For,4,208,2137
16,5,1,1,1,3,2,2149,174,55,34,96,the,4,208,2204
17,5,1,1,1,3,3,2217,184,86,33,96,year,4,217,2303
18,5,1,1,1,3,4,2315,174,118,36,96,ended,4,210,2433
19,5,1,1,1,3,5,2451,173,47,37,96,30,4,210,2498
20,5,1,1,1,3,6,2513,174,214,43,96,September,4,217,2727
21,5,1,1,1,3,7,2740,173,96,37,96,2007,4,210,2836
22,4,1,1,1,4,0,0,298,414,123,-1,,4,421,414
23,5,1,1,1,4,1,0,298,28,123,0,l,4,421,28
24,5,1,1,1,4,2,251,321,163,74,96,Notes,4,395,414
25,4,1,1,1,5,0,251,401,909,51,-1,,4,452,1160
26,5,1,1,1,5,1,251,401,188,51,95,(forming,4,452,439
27,5,1,1,1,5,2,453,411,94,41,95,part,4,452,547
28,5,1,1,1,5,3,563,402,50,50,96,of,4,452,613
29,5,1,1,1,5,4,620,403,66,38,96,the,4,441,686
30,5,1,1,1,5,5,692,403,205,49,95,financial,4,452,897
31,5,1,1,1,5,6,911,404,249,46,95,statements),4,450,1160
32,4,1,1,1,6,0,254,633,606,50,-1,,4,683,860
33,5,1,1,1,6,1,254,633,18,37,96,1,4,670,272
34,5,1,1,1,6,2,406,633,268,50,96,Accounting,4,683,674
35,5,1,1,1,6,3,690,633,170,49,96,policies,4,682,860
36,4,1,1,1,7,0,249,766,2577,51,-1,,4,817,2826
37,5,1,1,1,7,1,249,766,82,39,96,The,4,805,331
38,5,1,1,1,7,2,366,766,206,51,96,following,4,817,572
39,5,1,1,1,7,3,604,776,237,41,96,accounting,4,817,841
40,5,1,1,1,7,4,872,768,168,49,95,policies,4,817,1040
41,5,1,1,1,7,5,1072,768,99,37,96,have,4,805,1171
42,5,1,1,1,7,6,1204,768,99,37,96,been,4,805,1303
43,5,1,1,1,7,7,1332,768,160,49,70,applied,4,817,1492
44,5,1,1,1,7,8,1521,768,259,49,96,consistently,4,817,1780
45,5,1,1,1,7,9,1811,779,38,27,49,in,4,806,1849
46,5,1,1,1,7,10,1881,768,156,49,96,dealing,4,817,2037
47,5,1,1,1,7,11,2071,768,90,39,96,with,4,807,2161
48,5,1,1,1,7,12,2190,776,112,31,67,items,4,807,2302
49,5,1,1,1,7,13,2333,768,131,39,95,which,4,807,2464
50,5,1,1,1,7,14,2494,779,64,28,96,are,4,807,2558
51,5,1,1,1,7,15,2588,768,238,39,96,considered,4,807,2826
52,4,1,1,1,8,0,251,830,1254,51,-1,,4,881,1505
53,5,1,1,1,8,1,251,831,172,39,96,material,4,870,423
54,5,1,1,1,8,2,443,842,37,28,93,in,4,870,480
55,5,1,1,1,8,3,500,832,163,38,96,relation,4,870,663
56,5,1,1,1,8,4,682,840,39,30,96,to,4,870,721
57,5,1,1,1,8,5,739,832,62,38,93,the,4,870,801
58,5,1,1,1,8,6,818,832,238,49,0,companys,4,881,1056
59,5,1,1,1,8,7,1074,830,186,40,90,financial,4,870,1260
60,5,1,1,1,8,8,1277,839,228,32,96,statements,4,871,1505
61,4,1,1,1,9,0,248,930,459,51,-1,,4,981,707
62,5,1,1,1,9,1,248,932,119,37,86,Basts,4,969,367
63,5,1,1,1,9,2,382,930,53,51,96,of,4,981,435
64,5,1,1,1,9,3,438,936,269,45,96,preparation,4,981,707
65,4,1,1,1,10,0,249,1029,2576,52,-1,,4,1081,2825
66,5,1,1,1,10,1,249,1030,82,37,96,The,4,1067,331
67,5,1,1,1,10,2,359,1029,185,38,96,financial,4,1067,544
68,5,1,1,1,10,3,572,1038,227,31,96,statements,4,1069,799
69,5,1,1,1,10,4,824,1030,101,39,96,have,4,1069,925
70,5,1,1,1,10,5,951,1030,100,39,96,been,4,1069,1051
71,5,1,1,1,10,6,1078,1030,191,49,96,prepared,4,1079,1269
72,5,1,1,1,10,7,1296,1042,37,25,73,in,4,1067,1333
73,5,1,1,1,10,8,1358,1030,244,39,96,accordance,4,1069,1602
74,5,1,1,1,10,9,1630,1030,92,39,89,with,4,1069,1722
75,5,1,1,1,10,10,1747,1030,224,50,96,applicable,4,1080,1971
76,5,1,1,1,10,11,1997,1032,246,49,96,Accounting,4,1081,2243
77,5,1,1,1,10,12,2268,1030,218,39,96,Standards,4,1069,2486
78,5,1,1,1,10,13,2511,1030,76,39,96,and,4,1069,2587
79,5,1,1,1,10,14,2614,1031,126,38,95,under,4,1069,2740
80,5,1,1,1,10,15,2762,1031,63,38,96,the,4,1069,2825
81,4,1,1,1,11,0,249,1093,680,51,-1,,4,1144,929
82,5,1,1,1,11,1,249,1093,200,39,96,historical,4,1132,449
83,5,1,1,1,11,2,467,1103,87,29,96,cost,4,1132,554
84,5,1,1,1,11,3,570,1103,237,41,95,accounting,4,1144,807
85,5,1,1,1,11,4,825,1095,104,37,92,rules,4,1132,929
86,4,1,1,1,12,0,251,1189,196,60,-1,,4,1249,447
87,5,1,1,1,12,1,251,1189,196,60,96,Taxation,4,1249,447
88,4,1,1,1,13,0,249,1291,2578,52,-1,,4,1343,2827
89,5,1,1,1,13,1,249,1293,82,37,96,The,4,1330,331
90,5,1,1,1,13,2,349,1293,145,48,96,charge,4,1341,494
91,5,1,1,1,13,3,514,1291,62,39,96,for,4,1330,576
92,5,1,1,1,13,4,592,1300,174,30,96,taxation,4,1330,766
93,5,1,1,1,13,5,786,1304,31,28,96,1s,4,1332,817
94,5,1,1,1,13,6,836,1293,122,39,95,based,4,1332,958
95,5,1,1,1,13,7,978,1304,52,26,95,on,4,1330,1030
96,5,1,1,1,13,8,1048,1293,63,37,96,the,4,1330,1111
97,5,1,1,1,13,9,1130,1293,119,37,94,result,4,1330,1249
98,5,1,1,1,13,10,1270,1291,58,39,96,for,4,1330,1328
99,5,1,1,1,13,11,1347,1293,62,37,96,the,4,1330,1409
100,5,1,1,1,13,12,1427,1304,93,37,96,year,4,1341,1520
101,5,1,1,1,13,13,1536,1293,76,38,95,and,4,1331,1612
102,5,1,1,1,13,14,1632,1293,110,39,93,takes,4,1332,1742
103,5,1,1,1,13,15,1761,1301,80,30,76,mto,4,1331,1841
104,5,1,1,1,13,16,1861,1300,166,32,96,account,4,1332,2027
105,5,1,1,1,13,17,2045,1300,169,32,96,taxation,4,1332,2214
106,5,1,1,1,13,18,2233,1293,182,39,96,deferred,4,1332,2415
107,5,1,1,1,13,19,2435,1293,172,39,96,because,4,1332,2607
108,5,1,1,1,13,20,2625,1293,49,38,96,of,4,1331,2674
109,5,1,1,1,13,21,2688,1301,139,42,92,timing,4,1343,2827
110,4,1,1,1,14,0,248,1355,2578,51,-1,,4,1406,2826
111,5,1,1,1,14,1,248,1355,241,39,95,differences,4,1394,489
112,5,1,1,1,14,2,510,1357,177,37,95,between,4,1394,687
113,5,1,1,1,14,3,706,1357,62,37,96,the,4,1394,768
114,5,1,1,1,14,4,790,1363,204,31,96,treatment,4,1394,994
115,5,1,1,1,14,5,1013,1355,47,39,96,of,4,1394,1060
116,5,1,1,1,14,6,1074,1365,147,29,96,certain,4,1394,1221
117,5,1,1,1,14,7,1241,1364,111,30,95,items,4,1394,1352
118,5,1,1,1,14,8,1372,1355,60,39,96,for,4,1394,1432
119,5,1,1,1,14,9,1450,1365,172,29,96,taxation,4,1394,1622
120,5,1,1,1,14,10,1642,1357,76,37,96,and,4,1394,1718
121,5,1,1,1,14,11,1736,1365,238,41,96,accounting,4,1406,1974
122,5,1,1,1,14,12,1992,1368,190,38,92,purposes,4,1406,2182
123,5,1,1,1,14,13,2229,1356,190,38,92,Deferred,4,1394,2419
124,5,1,1,1,14,14,2441,1366,62,28,95,tax,4,1394,2503
125,5,1,1,1,14,15,2523,1369,33,25,93,1s,4,1394,2556
126,5,1,1,1,14,16,2576,1357,250,49,0,recognised,4,1406,2826
127,4,1,1,1,15,0,250,1420,2576,51,-1,,4,1471,2826
128,5,1,1,1,15,1,250,1420,162,39,93,without,4,1459,412
129,5,1,1,1,15,2,437,1420,267,51,91,discounting,4,1471,704
130,5,1,1,1,15,3,733,1432,37,25,94,in,4,1457,770
131,5,1,1,1,15,4,798,1428,152,43,95,respect,4,1471,950
132,5,1,1,1,15,5,976,1420,49,39,96,of,4,1459,1025
133,5,1,1,1,15,6,1046,1420,51,39,96,all,4,1459,1097
134,5,1,1,1,15,7,1125,1428,137,41,40,mung,4,1469,1262
135,5,1,1,1,15,8,1287,1420,241,39,96,differences,4,1459,1528
136,5,1,1,1,15,9,1555,1421,179,38,96,between,4,1459,1734
137,5,1,1,1,15,10,1760,1420,64,39,96,the,4,1459,1824
138,5,1,1,1,15,11,1851,1428,202,31,96,treatment,4,1459,2053
139,5,1,1,1,15,12,2080,1420,49,39,96,of,4,1459,2129
140,5,1,1,1,15,13,2151,1429,137,30,83,certain,4,1459,2288
141,5,1,1,1,15,14,2317,1430,116,29,66,items,4,1459,2433
142,5,1,1,1,15,15,2461,1420,62,39,93,for,4,1459,2523
143,5,1,1,1,15,16,2547,1428,175,31,80,taxauion,4,1459,2722
144,5,1,1,1,15,17,2750,1422,76,37,96,and,4,1459,2826
145,4,1,1,1,16,0,249,1484,2578,49,-1,,4,1533,2827
146,5,1,1,1,16,1,249,1492,237,41,95,accounting,4,1533,486
147,5,1,1,1,16,2,506,1496,194,37,96,purposes,4,1533,700
148,5,1,1,1,16,3,722,1484,128,38,96,which,4,1522,850
149,5,1,1,1,16,4,872,1484,100,38,96,have,4,1522,972
150,5,1,1,1,16,5,993,1496,128,28,96,arisen,4,1524,1121
151,5,1,1,1,16,6,1142,1484,70,39,96,but,4,1523,1212
152,5,1,1,1,16,7,1232,1493,64,30,96,not,4,1523,1296
153,5,1,1,1,16,8,1319,1484,181,40,96,reversed,4,1524,1500
154,5,1,1,1,16,9,1522,1484,51,49,96,by,4,1533,1573
155,5,1,1,1,16,10,1593,1484,64,40,96,the,4,1524,1657
156,5,1,1,1,16,11,1679,1484,164,40,96,balance,4,1524,1843
157,5,1,1,1,16,12,1866,1484,109,40,93,sheet,4,1524,1975
158,5,1,1,1,16,13,1994,1484,104,45,92,date,4,1529,2098
159,5,1,1,1,16,14,2120,1493,132,40,96,except,4,1533,2252
160,5,1,1,1,16,15,2274,1496,43,28,96,as,4,1524,2317
161,5,1,1,1,16,16,2341,1484,209,40,96,otherwise,4,1524,2550
162,5,1,1,1,16,17,2572,1484,182,49,96,required,4,1533,2754
163,5,1,1,1,16,18,2776,1484,51,49,96,by,4,1533,2827
164,4,1,1,1,17,0,250,1547,162,39,-1,,4,1586,412
165,5,1,1,1,17,1,250,1547,91,39,91,FRS,4,1586,341
166,5,1,1,1,17,2,367,1547,45,39,95,19,4,1586,412
167,4,1,1,1,18,0,249,1647,444,51,-1,,4,1698,693
168,5,1,1,1,18,1,249,1647,163,51,64,Capital,4,1698,412
169,5,1,1,1,18,2,425,1653,268,33,95,instruments,4,1686,693
170,4,1,1,1,19,0,250,1745,2577,51,-1,,4,1796,2827
171,5,1,1,1,19,1,250,1747,134,37,93,Under,4,1784,384
172,5,1,1,1,19,2,404,1747,93,37,91,FRS,4,1784,497
173,5,1,1,1,19,3,482,1741,50,59,96,4,4,1800,532
174,5,1,1,1,19,4,567,1759,105,25,66,issue,4,1784,672
175,5,1,1,1,19,5,694,1755,107,29,95,costs,4,1784,801
176,5,1,1,1,19,6,823,1757,147,39,96,arising,4,1796,970
177,5,1,1,1,19,7,991,1759,51,25,96,on,4,1784,1042
178,5,1,1,1,19,8,1066,1747,111,37,95,loans,4,1784,1177
179,5,1,1,1,19,9,1199,1759,65,25,95,are,4,1784,1264
180,5,1,1,1,19,10,1285,1747,196,37,96,deducted,4,1784,1481
181,5,1,1,1,19,11,1505,1745,99,39,94,from,4,1784,1604
182,5,1,1,1,19,12,1626,1747,64,37,96,the,4,1784,1690
183,5,1,1,1,19,13,1712,1755,63,29,96,net,4,1784,1775
184,5,1,1,1,19,14,1796,1747,194,49,95,proceeds,4,1796,1990
185,5,1,1,1,19,15,2010,1745,47,39,96,of,4,1784,2057
186,5,1,1,1,19,16,2074,1747,82,37,96,that,4,1784,2156
187,5,1,1,1,19,17,2175,1747,84,37,71,loan,4,1784,2259
188,5,1,1,1,19,18,2313,1747,96,38,71,This,4,1785,2409
189,5,1,1,1,19,19,2431,1747,141,39,96,results,4,1786,2572
190,5,1,1,1,19,20,2594,1759,37,25,91,in,4,1784,2631
191,5,1,1,1,19,21,2655,1747,63,37,96,the,4,1784,2718
192,5,1,1,1,19,22,2738,1755,89,29,96,cost,4,1784,2827
193,4,1,1,1,20,0,249,1810,1929,50,-1,,4,1860,2178
194,5,1,1,1,20,1,249,1810,118,50,96,being,4,1860,367
195,5,1,1,1,20,2,382,1810,173,50,96,charged,4,1860,555
196,5,1,1,1,20,3,572,1818,39,31,96,to,4,1849,611
197,5,1,1,1,20,4,629,1810,64,39,96,the,4,1849,693
198,5,1,1,1,20,5,709,1810,119,50,95,profit,4,1860,828
199,5,1,1,1,20,6,846,1810,76,39,96,and,4,1849,922
200,5,1,1,1,20,7,941,1810,82,39,96,loss,4,1849,1023
201,5,1,1,1,20,8,1040,1818,168,31,96,account,4,1849,1208
202,5,1,1,1,20,9,1226,1821,40,28,96,as,4,1849,1266
203,5,1,1,1,20,10,1285,1823,20,26,96,a,4,1849,1305
204,5,1,1,1,20,11,1325,1810,154,39,96,finance,4,1849,1479
205,5,1,1,1,20,12,1497,1819,83,30,96,cost,4,1849,1580
206,5,1,1,1,20,13,1599,1821,96,28,96,over,4,1849,1695
207,5,1,1,1,20,14,1711,1810,62,39,96,the,4,1849,1773
208,5,1,1,1,20,15,1792,1810,138,50,94,period,4,1860,1930
209,5,1,1,1,20,16,1947,1810,47,39,96,of,4,1849,1994
210,5,1,1,1,20,17,2006,1810,65,39,96,the,4,1849,2071
211,5,1,1,1,20,18,2089,1810,89,39,76,loan,4,1849,2178
212,4,1,1,1,21,0,247,1905,138,63,-1,,4,1968,385
213,5,1,1,1,21,1,247,1905,138,63,96,Stocks,4,1968,385
214,4,1,1,1,22,0,249,2007,2578,51,-1,,4,2058,2827
215,5,1,1,1,22,1,249,2007,141,40,96,Stocks,4,2047,390
216,5,1,1,1,22,2,408,2019,199,38,77,comprise,4,2057,607
217,5,1,1,1,22,3,625,2007,49,40,96,of,4,2047,674
218,5,1,1,1,22,4,688,2016,217,42,96,properties,4,2058,905
219,5,1,1,1,22,5,925,2007,90,40,96,held,4,2047,1015
220,5,1,1,1,22,6,1035,2007,62,40,96,for,4,2047,1097
221,5,1,1,1,22,7,1115,2007,125,40,88,resale,4,2047,1240
222,5,1,1,1,22,8,1289,2007,139,40,88,Stocks,4,2047,1428
223,5,1,1,1,22,9,1447,2019,65,28,95,are,4,2047,1512
224,5,1,1,1,22,10,1530,2008,123,39,96,stated,4,2047,1653
225,5,1,1,1,22,11,1673,2015,37,32,96,at,4,2047,1710
226,5,1,1,1,22,12,1728,2008,64,39,96,the,4,2047,1792
227,5,1,1,1,22,13,1811,2007,124,40,92,lower,4,2047,1935
228,5,1,1,1,22,14,1951,2007,47,40,96,of,4,2047,1998
229,5,1,1,1,22,15,2010,2016,87,31,96,cost,4,2047,2097
230,5,1,1,1,22,16,2116,2008,74,39,96,and,4,2047,2190
231,5,1,1,1,22,17,2208,2016,58,31,93,net,4,2047,2266
232,5,1,1,1,22,18,2284,2008,212,39,84,realisable,4,2047,2496
233,5,1,1,1,22,19,2514,2007,115,40,89,value,4,2047,2629
234,5,1,1,1,22,20,2676,2007,151,40,0,Costts,4,2047,2827
235,4,1,1,1,23,0,247,2072,2579,49,-1,,4,2121,2826
236,5,1,1,1,23,1,247,2072,243,37,93,determined,4,2109,490
237,5,1,1,1,23,2,510,2084,51,25,93,on,4,2109,561
238,5,1,1,1,23,3,578,2084,49,25,93,an,4,2109,627
239,5,1,1,1,23,4,645,2072,127,37,95,actual,4,2109,772
240,5,1,1,1,23,5,790,2072,107,37,96,basis,4,2109,897
241,5,1,1,1,23,6,917,2072,74,37,96,and,4,2109,991
242,5,1,1,1,23,7,1009,2084,221,37,93,comprises,4,2121,1230
243,5,1,1,1,23,8,1250,2072,100,45,92,land,4,2117,1350
244,5,1,1,1,23,9,1370,2080,184,41,96,property,4,2121,1554
245,5,1,1,1,23,10,1571,2072,74,37,96,and,4,2109,1645
246,5,1,1,1,23,11,1665,2072,198,39,60,materials,4,2111,1863
247,5,1,1,1,23,12,1910,2072,74,37,60,Net,4,2109,1984
248,5,1,1,1,23,13,2003,2072,206,37,90,realisable,4,2109,2209
249,5,1,1,1,23,14,2225,2072,112,39,96,value,4,2111,2337
250,5,1,1,1,23,15,2358,2084,32,27,91,1s,4,2111,2390
251,5,1,1,1,23,16,2406,2072,124,39,96,based,4,2111,2530
252,5,1,1,1,23,17,2546,2084,53,27,95,on,4,2111,2599
253,5,1,1,1,23,18,2615,2072,211,39,81,estimated,4,2111,2826
254,4,1,1,1,24,0,247,2135,1722,51,-1,,4,2186,1969
255,5,1,1,1,24,1,247,2135,143,51,90,selling,4,2186,390
256,5,1,1,1,24,2,408,2146,127,40,82,prices,4,2186,535
257,5,1,1,1,24,3,554,2137,77,37,96,less,4,2174,631
258,5,1,1,1,24,4,651,2135,145,39,96,further,4,2174,796
259,5,1,1,1,24,5,811,2144,108,30,96,costs,4,2174,919
260,5,1,1,1,24,6,937,2135,237,51,46,anticipated,4,2186,1174
261,5,1,1,1,24,7,1193,2144,41,30,93,to,4,2174,1234
262,5,1,1,1,24,8,1250,2137,188,49,75,disposal,4,2186,1438
263,5,1,1,1,24,9,1456,2137,213,49,96,excluding,4,2186,1669
264,5,1,1,1,24,10,1687,2144,158,30,96,interest,4,2174,1845
265,5,1,1,1,24,11,1861,2144,108,30,96,costs,4,2174,1969
266,4,1,1,1,25,0,246,2234,458,49,-1,,4,2283,704
267,5,1,1,1,25,1,246,2234,119,49,95,Long,4,2283,365
268,5,1,1,1,25,2,378,2241,102,33,95,term,4,2274,480
269,5,1,1,1,25,3,498,2241,206,33,96,contracts,4,2274,704
270,4,1,1,1,26,0,247,2332,2579,51,-1,,4,2383,2826
271,5,1,1,1,26,1,247,2332,82,40,96,The,4,2372,329
272,5,1,1,1,26,2,350,2341,161,31,96,amount,4,2372,511
273,5,1,1,1,26,3,529,2332,49,40,96,of,4,2372,578
274,5,1,1,1,26,4,592,2332,121,51,96,profit,4,2383,713
275,5,1,1,1,26,5,731,2333,249,39,71,attributable,4,2372,980
276,5,1,1,1,26,6,999,2341,41,31,96,to,4,2372,1040
277,5,1,1,1,26,7,1060,2334,63,38,96,the,4,2372,1123
278,5,1,1,1,26,8,1141,2341,111,42,96,stage,4,2383,1252
279,5,1,1,1,26,9,1270,2332,47,40,96,of,4,2372,1317
280,5,1,1,1,26,10,1330,2333,243,50,96,completion,4,2383,1573
281,5,1,1,1,26,11,1593,2332,47,40,96,of,4,2372,1640
282,5,1,1,1,26,12,1653,2346,23,26,96,a,4,2372,1676
283,5,1,1,1,26,13,1696,2334,93,49,96,long,4,2383,1789
284,5,1,1,1,26,14,1809,2342,97,30,94,term,4,2372,1906
285,5,1,1,1,26,15,1926,2342,172,30,96,contract,4,2372,2098
286,5,1,1,1,26,16,2120,2344,33,28,94,1s,4,2372,2153
287,5,1,1,1,26,17,2172,2334,229,49,96,recognised,4,2383,2401
288,5,1,1,1,26,18,2421,2334,114,38,96,when,4,2372,2535
289,5,1,1,1,26,19,2554,2334,63,38,96,the,4,2372,2617
290,5,1,1,1,26,20,2639,2342,187,30,96,outcome,4,2372,2826
291,4,1,1,1,27,0,247,2397,2580,51,-1,,4,2448,2827
292,5,1,1,1,27,1,247,2397,49,37,96,of,4,2434,296
293,5,1,1,1,27,2,310,2397,62,39,96,the,4,2436,372
294,5,1,1,1,27,3,388,2405,178,31,95,contract,4,2436,566
295,5,1,1,1,27,4,582,2409,74,27,95,can,4,2436,656
296,5,1,1,1,27,5,674,2397,49,39,96,be,4,2436,723
297,5,1,1,1,27,6,743,2397,183,39,96,foreseen,4,2436,926
298,5,1,1,1,27,7,944,2397,94,39,95,with,4,2436,1038
299,5,1,1,1,27,8,1055,2397,233,39,95,reasonable,4,2436,1288
300,5,1,1,1,27,9,1307,2405,187,42,66,certainty,4,2447,1494
301,5,1,1,1,27,10,1540,2399,205,37,66,Turnover,4,2436,1745
302,5,1,1,1,27,11,1762,2397,60,39,96,for,4,2436,1822
303,5,1,1,1,27,12,1839,2398,98,38,96,such,4,2436,1937
304,5,1,1,1,27,13,1955,2405,197,31,96,contracts,4,2436,2152
305,5,1,1,1,27,14,2171,2409,31,27,90,1s,4,2436,2202
306,5,1,1,1,27,15,2217,2397,120,39,96,stated,4,2436,2337
307,5,1,1,1,27,16,2357,2405,36,31,96,at,4,2436,2393
308,5,1,1,1,27,17,2410,2407,87,29,96,cost,4,2436,2497
309,5,1,1,1,27,18,2517,2405,249,43,96,appropriate,4,2448,2766
310,5,1,1,1,27,19,2787,2407,40,29,90,to,4,2436,2827
311,4,1,1,1,28,0,247,2460,2582,51,-1,,4,2511,2829
312,5,1,1,1,28,1,247,2462,99,37,95,their,4,2499,346
313,5,1,1,1,28,2,365,2470,107,41,96,stage,4,2511,472
314,5,1,1,1,28,3,492,2460,49,39,96,of,4,2499,541
315,5,1,1,1,28,4,555,2462,244,49,96,completion,4,2511,799
316,5,1,1,1,28,5,820,2462,87,49,96,plus,4,2511,907
317,5,1,1,1,28,6,929,2462,247,37,91,attributable,4,2499,1176
318,5,1,1,1,28,7,1196,2462,154,49,93,profits,4,2511,1350
319,5,1,1,1,28,8,1372,2462,76,39,96,less,4,2501,1448
320,5,1,1,1,28,9,1467,2470,182,31,96,amounts,4,2501,1649
321,5,1,1,1,28,10,1669,2462,237,49,57,recognised,4,2511,1906
322,5,1,1,1,28,11,1928,2473,35,26,74,in,4,2499,1963
323,5,1,1,1,28,12,1984,2473,188,38,96,previous,4,2511,2172
324,5,1,1,1,28,13,2191,2473,105,38,88,years,4,2511,2296
325,5,1,1,1,28,14,2347,2462,207,39,88,Provision,4,2501,2554
326,5,1,1,1,28,15,2576,2473,33,28,92,1s,4,2501,2609
327,5,1,1,1,28,16,2629,2462,115,39,96,made,4,2501,2744
328,5,1,1,1,28,17,2765,2462,64,39,96,for,4,2501,2829
329,4,1,1,1,29,0,247,2524,846,51,-1,,4,2575,1093
330,5,1,1,1,29,1,247,2538,76,37,96,any,4,2575,323
331,5,1,1,1,29,2,340,2526,127,38,96,losses,4,2564,467
332,5,1,1,1,29,3,484,2538,43,26,95,as,4,2564,527
333,5,1,1,1,29,4,544,2536,101,28,95,soon,4,2564,645
334,5,1,1,1,29,5,662,2536,42,28,95,as,4,2564,704
335,5,1,1,1,29,6,722,2526,89,49,95,they,4,2575,811
336,5,1,1,1,29,7,829,2537,64,27,96,are,4,2564,893
337,5,1,1,1,29,8,911,2524,182,40,96,foreseen,4,2564,1093
338,4,1,1,1,30,0,247,2624,2582,51,-1,,4,2675,2829
339,5,1,1,1,30,1,247,2624,186,39,96,Contract,4,2663,433
340,5,1,1,1,30,2,461,2624,107,39,96,work,4,2663,568
341,5,1,1,1,30,3,596,2636,37,27,79,in,4,2663,633
342,5,1,1,1,30,4,660,2636,185,39,96,progress,4,2675,845
343,5,1,1,1,30,5,872,2636,31,27,83,1s,4,2663,903
344,5,1,1,1,30,6,931,2624,124,39,96,stated,4,2663,1055
345,5,1,1,1,30,7,1083,2636,44,27,96,as,4,2663,1127
346,5,1,1,1,30,8,1150,2633,110,30,93,costs,4,2663,1260
347,5,1,1,1,30,9,1286,2625,191,44,82,incurted,4,2669,1477
348,5,1,1,1,30,10,1505,2625,78,38,77,Jess,4,2663,1583
349,5,1,1,1,30,11,1608,2625,114,38,96,those,4,2663,1722
350,5,1,1,1,30,12,1749,2624,235,39,96,transferred,4,2663,1984
351,5,1,1,1,30,13,2010,2633,41,30,96,to,4,2663,2051
352,5,1,1,1,30,14,2076,2625,65,38,96,the,4,2663,2141
353,5,1,1,1,30,15,2168,2624,111,49,96,profit,4,2673,2279
354,5,1,1,1,30,16,2306,2626,76,37,96,and,4,2663,2382
355,5,1,1,1,30,17,2409,2626,83,37,93,loss,4,2663,2492
356,5,1,1,1,30,18,2518,2634,181,33,92,account,4,2667,2699
357,5,1,1,1,30,19,2727,2624,102,39,96,after,4,2663,2829
358,4,1,1,1,31,0,247,2689,1788,49,-1,,4,2738,2035
359,5,1,1,1,31,1,247,2689,214,49,96,deducting,4,2738,461
360,5,1,1,1,31,2,479,2689,246,39,96,foreseeable,4,2728,725
361,5,1,1,1,31,3,743,2689,127,39,95,losses,4,2728,870
362,5,1,1,1,31,4,888,2689,76,37,96,and,4,2726,964
363,5,1,1,1,31,5,982,2697,205,41,96,payments,4,2738,1187
364,5,1,1,1,31,6,1205,2701,52,26,95,on,4,2727,1257
365,5,1,1,1,31,7,1275,2697,165,31,95,account,4,2728,1440
366,5,1,1,1,31,8,1458,2697,66,29,95,not,4,2726,1524
367,5,1,1,1,31,9,1542,2689,180,39,96,matched,4,2728,1722
368,5,1,1,1,31,10,1742,2689,91,37,96,with,4,2726,1833
369,5,1,1,1,31,11,1851,2697,184,31,96,turnover,4,2728,2035
370,4,1,1,1,32,0,247,2787,2580,51,-1,,4,2838,2827
371,5,1,1,1,32,1,247,2789,196,37,96,Amounts,4,2826,443
372,5,1,1,1,32,2,463,2787,256,39,96,recoverable,4,2826,719
373,5,1,1,1,32,3,739,2800,53,26,96,on,4,2826,792
374,5,1,1,1,32,4,811,2795,198,31,96,contracts,4,2826,1009
375,5,1,1,1,32,5,1031,2800,64,26,96,are,4,2826,1095
376,5,1,1,1,32,6,1117,2789,184,37,95,included,4,2826,1301
377,5,1,1,1,32,7,1324,2800,38,26,71,in,4,2826,1362
378,5,1,1,1,32,8,1383,2789,159,37,96,debtors,4,2826,1542
379,5,1,1,1,32,9,1562,2789,75,37,96,and,4,2826,1637
380,5,1,1,1,32,10,1659,2795,200,43,96,represent,4,2838,1859
381,5,1,1,1,32,11,1879,2797,184,29,96,turnover,4,2826,2063
382,5,1,1,1,32,12,2080,2789,231,49,36,recognised,4,2838,2311
383,5,1,1,1,32,13,2333,2800,39,26,49,in,4,2826,2372
384,5,1,1,1,32,14,2392,2800,143,28,96,excess,4,2828,2535
385,5,1,1,1,32,15,2554,2789,49,39,96,of,4,2828,2603
386,5,1,1,1,32,16,2618,2797,209,41,96,payments,4,2838,2827
387,4,1,1,1,33,0,247,2860,235,31,-1,,4,2891,482
388,5,1,1,1,33,1,247,2863,51,28,95,on,4,2891,298
389,5,1,1,1,33,2,318,2860,164,31,95,account,4,2891,482
390,4,1,1,1,34,0,247,2951,458,51,-1,,4,3002,705
391,5,1,1,1,34,1,247,2951,110,39,96,Cash,4,2990,357
392,5,1,1,1,34,2,365,2951,105,51,96,flow,4,3002,470
393,5,1,1,1,34,3,485,2958,220,32,96,statement,4,2990,705
394,4,1,1,1,35,0,248,3049,2579,51,-1,,4,3100,2827
395,5,1,1,1,35,1,248,3050,134,38,92,Under,4,3088,382
396,5,1,1,1,35,2,402,3050,92,38,92,FRS,4,3088,494
397,5,1,1,1,35,3,524,3051,11,37,59,1,4,3088,535
398,5,1,1,1,35,4,578,3051,62,37,96,the,4,3088,640
399,5,1,1,1,35,5,660,3061,200,39,96,company,4,3100,860
400,5,1,1,1,35,6,882,3061,31,27,95,is,4,3088,913
401,5,1,1,1,35,7,933,3059,160,41,96,exempt,4,3100,1093
402,5,1,1,1,35,8,1117,3049,100,39,96,from,4,3088,1217
403,5,1,1,1,35,9,1239,3050,62,38,96,the,4,3088,1301
404,5,1,1,1,35,10,1324,3059,260,41,96,requirement,4,3100,1584
405,5,1,1,1,35,11,1604,3059,40,29,96,to,4,3088,1644
406,5,1,1,1,35,12,1665,3063,163,37,96,prepare,4,3100,1828
407,5,1,1,1,35,13,1849,3063,23,25,96,a,4,3088,1872
408,5,1,1,1,35,14,1892,3050,96,38,96,cash,4,3088,1988
409,5,1,1,1,35,15,2010,3049,95,39,94,flow,4,3088,2105
410,5,1,1,1,35,16,2125,3057,201,31,96,statement,4,3088,2326
411,5,1,1,1,35,17,2347,3063,53,25,96,on,4,3088,2400
412,5,1,1,1,35,18,2421,3051,65,37,95,the,4,3088,2486
413,5,1,1,1,35,19,2505,3051,176,49,96,grounds,4,3100,2681
414,5,1,1,1,35,20,2703,3051,78,37,96,that,4,3088,2781
415,5,1,1,1,35,21,2805,3063,22,25,96,a,4,3088,2827
416,4,1,1,1,36,0,247,3114,2096,51,-1,,4,3165,2343
417,5,1,1,1,36,1,247,3123,135,40,96,parent,4,3163,382
418,5,1,1,1,36,2,400,3114,257,51,96,undertaking,4,3165,657
419,5,1,1,1,36,3,676,3114,178,39,96,includes,4,3153,854
420,5,1,1,1,36,4,871,3114,64,39,96,the,4,3153,935
421,5,1,1,1,36,5,952,3126,198,38,93,company,4,3164,1150
422,5,1,1,1,36,6,1168,3126,37,27,81,1n,4,3153,1205
423,5,1,1,1,36,7,1225,3122,48,31,87,its,4,3153,1273
424,5,1,1,1,36,8,1289,3126,88,27,96,own,4,3153,1377
425,5,1,1,1,36,9,1397,3114,207,51,95,published,4,3165,1604
426,5,1,1,1,36,10,1620,3114,278,39,96,consolidated,4,3153,1898
427,5,1,1,1,36,11,1919,3114,183,39,95,financial,4,3153,2102
428,5,1,1,1,36,12,2121,3122,222,31,96,statements,4,3153,2343
429,4,1,1,1,37,0,247,3214,539,51,-1,,4,3265,786
430,5,1,1,1,37,1,247,3214,129,39,96,Other,4,3253,376
431,5,1,1,1,37,2,390,3222,217,43,96,operating,4,3265,607
432,5,1,1,1,37,3,621,3225,165,28,96,income,4,3253,786
433,4,1,1,1,38,0,247,3312,2580,51,-1,,4,3363,2827
434,5,1,1,1,38,1,247,3312,124,39,96,Other,4,3351,371
435,5,1,1,1,38,2,394,3321,206,42,95,operating,4,3363,600
436,5,1,1,1,38,3,627,3323,157,28,95,income,4,3351,784
437,5,1,1,1,38,4,810,3320,221,43,96,represents,4,3363,1031
438,5,1,1,1,38,5,1058,3321,206,42,96,operating,4,3363,1264
439,5,1,1,1,38,6,1292,3314,103,39,96,lease,4,3353,1395
440,5,1,1,1,38,7,1423,3325,156,26,96,income,4,3351,1579
441,5,1,1,1,38,8,1606,3314,129,37,96,which,4,3351,1735
442,5,1,1,1,38,9,1762,3325,32,26,74,1s,4,3351,1794
443,5,1,1,1,38,10,1820,3314,176,37,96,credited,4,3351,1996
444,5,1,1,1,38,11,2024,3321,39,30,95,to,4,3351,2063
445,5,1,1,1,38,12,2088,3312,65,39,95,the,4,3351,2153
446,5,1,1,1,38,13,2182,3312,111,51,95,profit,4,3363,2293
447,5,1,1,1,38,14,2317,3314,79,37,94,and,4,3351,2396
448,5,1,1,1,38,15,2423,3314,80,39,72,Joss,4,3353,2503
449,5,1,1,1,38,16,2531,3321,170,32,96,account,4,3353,2701
450,5,1,1,1,38,17,2725,3325,53,27,96,on,4,3352,2778
451,5,1,1,1,38,18,2805,3325,22,27,96,a,4,3352,2827
452,4,1,1,1,39,0,247,3376,1600,51,-1,,4,3427,1847
453,5,1,1,1,39,1,247,3378,161,49,71,straight,4,3427,408
454,5,1,1,1,39,2,425,3378,77,37,95,line,4,3415,502
455,5,1,1,1,39,3,520,3378,107,37,96,basis,4,3415,627
456,5,1,1,1,39,4,645,3388,96,27,96,over,4,3415,741
457,5,1,1,1,39,5,757,3376,62,39,96,the,4,3415,819
458,5,1,1,1,39,6,837,3376,139,51,96,period,4,3427,976
459,5,1,1,1,39,7,993,3376,49,39,95,of,4,3415,1042
460,5,1,1,1,39,8,1054,3377,63,38,96,the,4,3415,1117
461,5,1,1,1,39,9,1136,3378,104,37,96,lease,4,3415,1240
462,5,1,1,1,39,10,1260,3385,41,30,96,to,4,3415,1301
463,5,1,1,1,39,11,1317,3378,62,37,96,the,4,3415,1379
464,5,1,1,1,39,12,1397,3377,83,40,96,first,4,3417,1480
465,5,1,1,1,39,13,1497,3384,83,31,96,rent,4,3415,1580
466,5,1,1,1,39,14,1597,3388,147,27,96,review,4,3415,1744
467,5,1,1,1,39,15,1759,3378,88,37,96,date,4,3415,1847
468,4,1,1,1,40,0,0,3829,20,24,-1,,4,3853,20
469,5,1,1,1,40,1,0,3829,20,24,52,»,4,3853,20
0,1,1,0,0,0,0,0,0,3106,3853,-1,,5,3853,3106
1,2,1,1,0,0,0,0,54,2838,3799,-1,,5,3853,2838
2,3,1,1,1,0,0,0,54,2838,3799,-1,,5,3853,2838
3,4,1,1,1,1,0,2214,54,624,45,-1,,5,99,2838
4,5,1,1,1,1,1,2214,54,227,35,92,Castlemore,5,89,2441
5,5,1,1,1,1,2,2457,54,142,45,96,Ranger,5,99,2599
6,5,1,1,1,1,3,2612,54,55,41,96,(3),5,95,2667
7,5,1,1,1,1,4,2685,54,153,35,41,Limited,5,89,2838
8,4,1,1,1,2,0,2016,116,822,44,-1,,5,160,2838
9,5,1,1,1,2,1,2016,117,189,35,0,Directors®,5,152,2205
10,5,1,1,1,2,2,2224,123,118,37,96,report,5,160,2342
11,5,1,1,1,2,3,2357,117,71,33,96,and,5,150,2428
12,5,1,1,1,2,4,2446,116,168,36,96,financial,5,152,2614
13,5,1,1,1,2,5,2630,123,208,29,96,statements,5,152,2838
14,4,1,1,1,3,0,2069,174,767,45,-1,,5,219,2836
15,5,1,1,1,3,1,2069,174,68,35,96,For,5,209,2137
16,5,1,1,1,3,2,2150,174,55,35,96,the,5,209,2205
17,5,1,1,1,3,3,2218,183,85,34,96,year,5,217,2303
18,5,1,1,1,3,4,2316,174,118,35,96,ended,5,209,2434
19,5,1,1,1,3,5,2450,174,49,35,96,30,5,209,2499
20,5,1,1,1,3,6,2514,174,212,45,95,September,5,219,2726
21,5,1,1,1,3,7,2742,174,94,35,96,2007,5,209,2836
22,4,1,1,1,4,0,0,295,714,126,-1,,5,421,714
23,5,1,1,1,4,1,0,295,23,126,0,/,5,421,23
24,5,1,1,1,4,2,248,325,168,51,95,Notes,5,376,416
25,5,1,1,1,4,3,438,333,276,51,95,(continued),5,384,714
26,4,1,1,1,5,0,250,538,919,49,-1,,5,587,1169
27,5,1,1,1,5,1,250,538,18,38,94,1,5,576,268
28,5,1,1,1,5,2,446,538,267,49,96,Accounting,5,587,713
29,5,1,1,1,5,3,731,538,170,49,96,policies,5,587,901
30,5,1,1,1,5,4,916,538,253,47,96,(continued),5,585,1169
31,4,1,1,1,6,0,246,638,592,51,-1,,5,689,838
32,5,1,1,1,6,1,246,638,172,40,96,Related,5,678,418
33,5,1,1,1,6,2,427,645,120,44,95,party,5,689,547
34,5,1,1,1,6,3,562,640,276,38,95,transactions,5,678,838
35,4,1,1,1,7,0,246,737,2580,52,-1,,5,789,2826
36,5,1,1,1,7,1,246,738,56,38,96,As,5,776,302
37,5,1,1,1,7,2,326,737,63,39,96,the,5,776,389
38,5,1,1,1,7,3,410,748,200,39,96,company,5,787,610
39,5,1,1,1,7,4,632,749,31,27,77,1s,5,776,663
40,5,1,1,1,7,5,685,738,217,49,91,ulumately,5,787,902
41,5,1,1,1,7,6,921,750,23,27,95,a,5,777,944
42,5,1,1,1,7,7,965,738,147,49,95,wholly,5,787,1112
43,5,1,1,1,7,8,1130,738,144,40,96,owned,5,778,1274
44,5,1,1,1,7,9,1297,738,225,49,96,subsidiary,5,787,1522
45,5,1,1,1,7,10,1540,738,48,38,93,of,5,776,1588
46,5,1,1,1,7,11,1603,738,246,40,90,Castlemore,5,778,1849
47,5,1,1,1,7,12,1871,738,137,51,96,Group,5,789,2008
48,5,1,1,1,7,13,2030,738,192,51,93,Holdings,5,789,2222
49,5,1,1,1,7,14,2244,739,184,45,87,Limited,5,784,2428
50,5,1,1,1,7,15,2452,740,64,38,96,the,5,778,2516
51,5,1,1,1,7,16,2536,750,200,39,96,company,5,789,2736
52,5,1,1,1,7,17,2758,740,68,38,96,has,5,778,2826
53,4,1,1,1,8,0,248,801,2577,51,-1,,5,852,2825
54,5,1,1,1,8,1,248,801,113,39,96,taken,5,840,361
55,5,1,1,1,8,2,381,802,221,50,95,advantage,5,852,602
56,5,1,1,1,8,3,621,801,48,39,96,of,5,840,669
57,5,1,1,1,8,4,683,803,62,37,96,the,5,840,745
58,5,1,1,1,8,5,763,811,228,41,96,exemption,5,852,991
59,5,1,1,1,8,6,1010,803,210,37,96,contained,5,840,1220
60,5,1,1,1,8,7,1242,815,37,25,87,in,5,840,1279
61,5,1,1,1,8,8,1301,803,92,37,91,FRS,5,840,1393
62,5,1,1,1,8,9,1414,802,24,38,96,8,5,840,1438
63,5,1,1,1,8,10,1457,803,77,37,93,and,5,840,1534
64,5,1,1,1,8,11,1554,803,80,43,0,has,5,846,1634
65,5,1,1,1,8,12,1655,803,208,42,92,therefore,5,845,1863
66,5,1,1,1,8,13,1885,812,64,30,96,not,5,842,1949
67,5,1,1,1,8,14,1967,803,203,39,96,disclosed,5,842,2170
68,5,1,1,1,8,15,2187,803,186,39,96,balances,5,842,2373
69,5,1,1,1,8,16,2391,815,45,27,96,or,5,842,2436
70,5,1,1,1,8,17,2454,812,260,30,93,transactions,5,842,2714
71,5,1,1,1,8,18,2734,804,91,38,96,with,5,842,2825
72,4,1,1,1,9,0,246,866,2578,51,-1,,5,917,2824
73,5,1,1,1,9,1,246,874,157,31,64,enuties,5,905,403
74,5,1,1,1,9,2,428,866,129,39,96,which,5,905,557
75,5,1,1,1,9,3,585,866,100,39,95,form,5,905,685
76,5,1,1,1,9,4,710,874,82,43,96,part,5,917,792
77,5,1,1,1,9,5,816,866,49,39,95,of,5,905,865
78,5,1,1,1,9,6,885,868,63,37,96,the,5,905,948
79,5,1,1,1,9,7,973,878,124,39,96,group,5,917,1097
80,5,1,1,1,9,8,1122,868,65,46,92,(or,5,914,1187
81,5,1,1,1,9,9,1212,874,196,31,8,mvestees,5,905,1408
82,5,1,1,1,9,10,1433,866,49,39,96,of,5,905,1482
83,5,1,1,1,9,11,1501,868,62,37,96,the,5,905,1563
84,5,1,1,1,9,12,1587,880,127,37,96,group,5,917,1714
85,5,1,1,1,9,13,1738,867,219,50,56,qualifying,5,917,1957
86,5,1,1,1,9,14,1981,880,43,25,96,as,5,905,2024
87,5,1,1,1,9,15,2048,868,145,39,96,related,5,907,2193
88,5,1,1,1,9,16,2217,870,164,47,94,parties),5,917,2381
89,5,1,1,1,9,17,2440,868,84,38,91,The,5,906,2524
90,5,1,1,1,9,18,2548,868,276,39,96,consolidated,5,907,2824
91,4,1,1,1,10,0,248,929,2578,53,-1,,5,982,2826
92,5,1,1,1,10,1,248,929,186,41,91,financial,5,970,434
93,5,1,1,1,10,2,454,938,227,32,96,statements,5,970,681
94,5,1,1,1,10,3,701,931,47,39,93,of,5,970,748
95,5,1,1,1,10,4,759,931,247,39,87,Castlemore,5,970,1006
96,5,1,1,1,10,5,1024,931,139,51,96,Group,5,982,1163
97,5,1,1,1,10,6,1182,931,199,51,93,Holdings,5,982,1381
98,5,1,1,1,10,7,1399,931,182,45,78,Limited,5,976,1581
99,5,1,1,1,10,8,1601,931,135,39,96,within,5,970,1736
100,5,1,1,1,10,9,1754,933,129,37,96,which,5,970,1883
101,5,1,1,1,10,10,1903,933,74,37,95,this,5,970,1977
102,5,1,1,1,10,11,1993,944,198,38,95,company,5,982,2191
103,5,1,1,1,10,12,2207,942,32,28,93,1s,5,970,2239
104,5,1,1,1,10,13,2259,933,200,40,91,included,5,973,2459
105,5,1,1,1,10,14,2479,944,73,26,96,can,5,970,2552
106,5,1,1,1,10,15,2571,933,47,37,96,be,5,970,2618
107,5,1,1,1,10,16,2638,933,188,37,96,obtained,5,970,2826
108,4,1,1,1,11,0,248,993,729,51,-1,,5,1044,977
109,5,1,1,1,11,1,248,993,102,40,96,from,5,1033,350
110,5,1,1,1,11,2,367,995,63,38,96,the,5,1033,430
111,5,1,1,1,11,3,448,995,162,39,96,address,5,1034,610
112,5,1,1,1,11,4,628,1007,117,37,96,given,5,1044,745
113,5,1,1,1,11,5,763,1007,38,26,93,in,5,1033,801
114,5,1,1,1,11,6,819,1003,91,32,96,note,5,1035,910
115,5,1,1,1,11,7,934,995,43,38,96,12,5,1033,977
116,4,1,1,1,12,0,248,1095,211,40,-1,,5,1135,459
117,5,1,1,1,12,1,248,1095,211,40,96,Turnover,5,1135,459
118,4,1,1,1,13,0,246,1193,2580,51,-1,,5,1244,2826
119,5,1,1,1,13,1,246,1193,204,40,95,Turnover,5,1233,450
120,5,1,1,1,13,2,470,1205,33,28,84,1s,5,1233,503
121,5,1,1,1,13,3,522,1193,125,40,96,stated,5,1233,647
122,5,1,1,1,13,4,667,1202,37,31,96,at,5,1233,704
123,5,1,1,1,13,5,722,1202,86,31,96,cost,5,1233,808
124,5,1,1,1,13,6,828,1201,248,43,96,appropriate,5,1244,1076
125,5,1,1,1,13,7,1097,1202,39,31,96,to,5,1233,1136
126,5,1,1,1,13,8,1156,1194,62,39,96,the,5,1233,1218
127,5,1,1,1,13,9,1240,1201,110,43,96,stage,5,1244,1350
128,5,1,1,1,13,10,1369,1193,47,40,93,of,5,1233,1416
129,5,1,1,1,13,11,1430,1194,243,50,21,comptetion,5,1244,1673
130,5,1,1,1,13,12,1695,1193,47,40,96,of,5,1233,1742
131,5,1,1,1,13,13,1755,1195,93,49,96,long,5,1244,1848
132,5,1,1,1,13,14,1868,1202,97,31,96,term,5,1233,1965
133,5,1,1,1,13,15,1983,1202,196,31,96,contracts,5,1233,2179
134,5,1,1,1,13,16,2197,1194,85,50,96,plus,5,1244,2282
135,5,1,1,1,13,17,2303,1195,249,38,93,attributable,5,1233,2552
136,5,1,1,1,13,18,2572,1193,154,51,92,profits,5,1244,2726
137,5,1,1,1,13,19,2748,1195,78,38,96,less,5,1233,2826
138,4,1,1,1,14,0,246,1258,1936,51,-1,,5,1309,2182
139,5,1,1,1,14,1,246,1266,182,31,93,amounts,5,1297,428
140,5,1,1,1,14,2,446,1258,234,49,91,recogntsed,5,1307,680
141,5,1,1,1,14,3,699,1270,37,25,70,in,5,1295,736
142,5,1,1,1,14,4,754,1270,185,37,93,previous,5,1307,939
143,5,1,1,1,14,5,956,1258,172,49,83,periods,5,1307,1128
144,5,1,1,1,14,6,1146,1258,52,38,95,all,5,1296,1198
145,5,1,1,1,14,7,1216,1258,49,39,96,of,5,1297,1265
146,5,1,1,1,14,8,1277,1258,129,39,96,which,5,1297,1406
147,5,1,1,1,14,9,1422,1270,65,27,96,are,5,1297,1487
148,5,1,1,1,14,10,1507,1258,152,39,96,located,5,1297,1659
149,5,1,1,1,14,11,1680,1270,36,27,96,in,5,1297,1716
150,5,1,1,1,14,12,1736,1258,61,39,96,the,5,1297,1797
151,5,1,1,1,14,13,1815,1258,146,39,94,United,5,1297,1961
152,5,1,1,1,14,14,1981,1258,201,51,94,Kingdom,5,1309,2182
153,4,1,1,1,15,0,246,1387,1180,50,-1,,5,1437,1426
154,5,1,1,1,15,1,246,1387,25,38,97,2,5,1425,271
155,5,1,1,1,15,2,403,1387,137,40,95,Profit,5,1427,540
156,5,1,1,1,15,3,555,1399,57,28,95,on,5,1427,612
157,5,1,1,1,15,4,628,1387,204,50,95,ordinary,5,1437,832
158,5,1,1,1,15,5,850,1387,205,40,95,activities,5,1427,1055
159,5,1,1,1,15,6,1072,1387,148,40,96,before,5,1427,1220
160,5,1,1,1,15,7,1236,1393,190,34,96,taxation,5,1427,1426
161,4,1,1,1,16,0,2301,1482,494,54,-1,,5,1536,2795
162,5,1,1,1,16,1,2301,1482,95,54,96,2007,5,1536,2396
163,5,1,1,1,16,2,2695,1486,100,35,96,2006,5,1521,2795
164,4,1,1,1,17,0,2383,1542,418,36,-1,,5,1578,2801
165,5,1,1,1,17,1,2383,1542,23,36,93,£,5,1578,2406
166,5,1,1,1,17,2,2778,1542,23,36,92,£,5,1578,2801
167,4,1,1,1,18,0,244,1599,1070,45,-1,,5,1644,1314
168,5,1,1,1,18,1,244,1599,117,45,96,Profit,5,1644,361
169,5,1,1,1,18,2,375,1611,51,24,95,on,5,1635,426
170,5,1,1,1,18,3,442,1599,178,45,95,ordinary,5,1644,620
171,5,1,1,1,18,4,632,1605,176,30,95,activities,5,1635,808
172,5,1,1,1,18,5,823,1599,129,45,95,before,5,1644,952
173,5,1,1,1,18,6,965,1605,167,30,95,taxation,5,1635,1132
174,5,1,1,1,18,7,1148,1611,31,24,70,ts,5,1635,1179
175,5,1,1,1,18,8,1193,1599,121,36,96,stated,5,1635,1314
176,4,1,1,1,19,0,244,1715,511,45,-1,,5,1760,755
177,5,1,1,1,19,1,244,1715,94,43,96,after,5,1758,338
178,5,1,1,1,19,2,352,1718,194,37,87,(crediting,5,1755,546
179,5,1,1,1,19,3,552,1710,202,55,53,Vcharging,5,1765,754
180,4,1,1,1,20,0,246,1827,2572,55,-1,,5,1882,2818
181,5,1,1,1,20,1,246,1831,106,33,96,Rents,5,1864,352
182,5,1,1,1,20,2,367,1831,196,33,96,receivable,5,1864,563
183,5,1,1,1,20,3,579,1831,108,33,96,under,5,1864,687
184,5,1,1,1,20,4,699,1837,180,39,96,operating,5,1876,879
185,5,1,1,1,20,5,893,1831,111,35,96,leases,5,1866,1004
186,5,1,1,1,20,6,2316,1827,106,55,96,(138),5,1882,2422
187,5,1,1,1,20,7,2620,1831,198,42,0,(124901),5,1873,2818
188,4,1,1,1,21,0,246,1885,2554,55,-1,,5,1940,2800
189,5,1,1,1,21,1,246,1889,107,34,96,Audit,5,1923,353
190,5,1,1,1,21,2,368,1888,74,35,96,fees,5,1923,442
191,5,1,1,1,21,3,456,1889,148,44,96,payable,5,1933,604
192,5,1,1,1,21,4,618,1896,35,27,96,to,5,1923,653
193,5,1,1,1,21,5,667,1889,57,34,92,the,5,1923,724
194,5,1,1,1,21,6,736,1889,208,45,0,companys,5,1934,944
195,5,1,1,1,21,7,959,1889,136,36,96,auditor,5,1925,1095
196,5,1,1,1,21,8,1109,1888,52,36,96,for,5,1924,1161
197,5,1,1,1,21,9,1175,1889,59,34,96,the,5,1923,1234
198,5,1,1,1,21,10,1246,1889,97,34,95,audit,5,1923,1343
199,5,1,1,1,21,11,1357,1888,41,36,97,of,5,1924,1398
200,5,1,1,1,21,12,1407,1889,58,34,96,the,5,1923,1465
201,5,1,1,1,21,13,1479,1889,125,34,96,annual,5,1923,1604
202,5,1,1,1,21,14,1620,1896,167,29,96,accounts,5,1925,1787
203,5,1,1,1,21,15,2293,1889,113,44,0,2650,5,1933,2406
204,5,1,1,1,21,16,2689,1885,111,55,0,2500,5,1940,2800
205,4,1,1,1,22,0,244,2107,1902,49,-1,,5,2156,2146
206,5,1,1,1,22,1,244,2107,82,39,95,The,5,2146,326
207,5,1,1,1,22,2,344,2107,107,37,93,audit,5,2144,451
208,5,1,1,1,22,3,471,2107,102,39,0,fees,5,2146,573
209,5,1,1,1,22,4,593,2119,99,25,96,were,5,2144,692
210,5,1,1,1,22,5,709,2107,122,39,96,borne,5,2146,831
211,5,1,1,1,22,6,848,2107,51,49,93,by,5,2156,899
212,5,1,1,1,22,7,914,2107,247,39,92,Castlemore,5,2146,1161
213,5,1,1,1,22,8,1181,2107,214,39,31,Securities,5,2146,1395
214,5,1,1,1,22,9,1411,2107,184,45,65,Limited,5,2152,1595
215,5,1,1,1,22,10,1612,2119,22,25,95,a,5,2144,1634
216,5,1,1,1,22,11,1652,2107,135,39,95,fellow,5,2146,1787
217,5,1,1,1,22,12,1803,2119,127,37,95,group,5,2156,1930
218,5,1,1,1,22,13,1946,2119,200,37,95,company,5,2156,2146
219,4,1,1,1,23,0,244,2272,717,39,-1,,5,2311,961
220,5,1,1,1,23,1,244,2272,25,39,96,3,5,2311,269
221,5,1,1,1,23,2,401,2272,117,39,95,Staff,5,2311,518
222,5,1,1,1,23,3,532,2272,202,39,95,numbers,5,2311,734
223,5,1,1,1,23,4,750,2272,84,39,96,and,5,2311,834
224,5,1,1,1,23,5,852,2278,109,33,96,costs,5,2311,961
225,4,1,1,1,24,0,244,2405,2564,51,-1,,5,2456,2808
226,5,1,1,1,24,1,244,2405,82,39,96,The,5,2444,326
227,5,1,1,1,24,2,346,2405,96,49,95,only,5,2454,442
228,5,1,1,1,24,3,461,2405,232,51,95,employees,5,2456,693
229,5,1,1,1,24,4,714,2405,47,39,96,of,5,2444,761
230,5,1,1,1,24,5,777,2405,63,39,96,the,5,2444,840
231,5,1,1,1,24,6,859,2417,198,39,95,company,5,2456,1057
232,5,1,1,1,24,7,1075,2417,65,27,95,are,5,2444,1140
233,5,1,1,1,24,8,1161,2406,65,38,95,the,5,2444,1226
234,5,1,1,1,24,9,1246,2406,192,38,96,directors,5,2444,1438
235,5,1,1,1,24,10,1458,2406,92,38,96,who,5,2444,1550
236,5,1,1,1,24,11,1569,2406,67,38,96,did,5,2444,1636
237,5,1,1,1,24,12,1657,2415,66,29,96,not,5,2444,1723
238,5,1,1,1,24,13,1744,2417,155,27,95,receive,5,2444,1899
239,5,1,1,1,24,14,1920,2417,75,37,96,any,5,2454,1995
240,5,1,1,1,24,15,2014,2415,285,29,95,remuneration,5,2444,2299
241,5,1,1,1,24,16,2320,2407,143,49,96,during,5,2456,2463
242,5,1,1,1,24,17,2483,2407,64,37,96,the,5,2444,2547
243,5,1,1,1,24,18,2567,2419,92,37,96,year,5,2456,2659
244,5,1,1,1,24,19,2678,2405,130,47,96,(2006,5,2452,2808
245,4,1,1,1,25,0,242,2470,111,45,-1,,5,2515,353
246,5,1,1,1,25,1,242,2470,111,45,89,£Nil),5,2515,353
247,4,1,1,1,26,0,242,2599,1204,40,-1,,5,2639,1446
248,5,1,1,1,26,1,242,2599,27,38,97,4,5,2637,269
249,5,1,1,1,26,2,401,2599,141,40,96,Other,5,2639,542
250,5,1,1,1,26,3,558,2604,174,35,96,interest,5,2639,732
251,5,1,1,1,26,4,750,2599,233,40,95,receivable,5,2639,983
252,5,1,1,1,26,5,999,2599,86,40,96,and,5,2639,1085
253,5,1,1,1,26,6,1101,2599,164,40,96,similar,5,2639,1265
254,5,1,1,1,26,7,1281,2599,165,40,96,income,5,2639,1446
255,4,1,1,1,27,0,2299,2690,494,59,-1,,5,2749,2793
256,5,1,1,1,27,1,2299,2690,99,59,96,2007,5,2749,2398
257,5,1,1,1,27,2,2695,2697,98,36,96,2006,5,2733,2793
258,4,1,1,1,28,0,2383,2754,416,36,-1,,5,2790,2799
259,5,1,1,1,28,1,2383,2756,20,34,13,g,5,2790,2403
260,5,1,1,1,28,2,2775,2754,24,36,79,£,5,2790,2799
261,4,1,1,1,29,0,244,2868,2555,39,-1,,5,2907,2799
262,5,1,1,1,29,1,244,2868,100,35,96,Bank,5,2903,344
263,5,1,1,1,29,2,357,2876,141,27,83,interest,5,2903,498
264,5,1,1,1,29,3,2391,2890,14,7,66,-,5,2897,2405
265,5,1,1,1,29,4,2662,2870,137,37,0,33399,5,2907,2799
266,4,1,1,1,30,0,244,2927,2553,45,-1,,5,2972,2797
267,5,1,1,1,30,1,244,2927,121,45,96,Group,5,2972,365
268,5,1,1,1,30,2,379,2935,141,29,96,interest,5,2964,520
269,5,1,1,1,30,3,534,2929,160,35,84,received,5,2964,694
270,5,1,1,1,30,4,2269,2929,136,43,0,76000,5,2972,2405
271,5,1,1,1,30,5,2636,2929,161,36,0,311913,5,2965,2797
272,4,1,1,1,31,0,244,2986,2553,45,-1,,5,3031,2797
273,5,1,1,1,31,1,244,2986,109,35,95,Other,5,3021,353
274,5,1,1,1,31,2,365,2994,141,29,96,interest,5,3023,506
275,5,1,1,1,31,3,2293,2988,104,43,0,2036,5,3031,2397
276,5,1,1,1,31,4,2687,2988,21,35,87,8,5,3023,2708
277,5,1,1,1,31,5,2726,2988,71,35,87,593,5,3023,2797
278,4,1,1,1,32,0,2267,3135,530,56,-1,,5,3191,2797
279,5,1,1,1,32,1,2267,3141,131,41,0,78036,5,3182,2398
280,5,1,1,1,32,2,2638,3135,159,56,0,353905,5,3191,2797
281,4,1,1,1,33,0,242,3358,1013,51,-1,,5,3409,1255
282,5,1,1,1,33,1,242,3358,25,39,0,5,5,3397,267
283,5,1,1,1,33,2,401,3358,182,39,96,Interest,5,3397,583
284,5,1,1,1,33,3,601,3358,178,51,96,payable,5,3409,779
285,5,1,1,1,33,4,797,3358,84,39,96,and,5,3397,881
286,5,1,1,1,33,5,898,3358,161,39,91,similar,5,3397,1059
287,5,1,1,1,33,6,1075,3358,180,51,96,charges,5,3409,1255
288,4,1,1,1,34,0,2299,3449,494,59,-1,,5,3508,2793
289,5,1,1,1,34,1,2299,3449,99,59,96,2007,5,3508,2398
290,5,1,1,1,34,2,2693,3449,100,59,96,2006,5,3508,2793
291,4,1,1,1,35,0,2382,3515,417,35,-1,,5,3550,2799
292,5,1,1,1,35,1,2382,3515,23,35,92,£,5,3550,2405
293,5,1,1,1,35,2,2775,3515,24,35,89,£,5,3550,2799
294,4,1,1,1,36,0,242,3629,2557,38,-1,,5,3667,2799
295,5,1,1,1,36,1,242,3629,58,35,96,On,5,3664,300
296,5,1,1,1,36,2,314,3629,92,35,96,bank,5,3664,406
297,5,1,1,1,36,3,422,3631,100,35,96,loans,5,3666,522
298,5,1,1,1,36,4,538,3631,66,35,96,and,5,3666,604
299,5,1,1,1,36,5,618,3629,192,37,54,overdrafts,5,3666,810
300,5,1,1,1,36,6,2391,3648,14,8,70,-,5,3656,2405
301,5,1,1,1,36,7,2663,3631,136,36,0,72534,5,3667,2799
302,4,1,1,1,37,0,242,3686,2556,55,-1,,5,3741,2798
303,5,1,1,1,37,1,242,3688,110,35,96,Other,5,3723,352
304,5,1,1,1,37,2,365,3696,141,29,96,interest,5,3725,506
305,5,1,1,1,37,3,2330,3686,74,55,95,284,5,3741,2404
306,5,1,1,1,37,4,2785,3709,13,6,72,-,5,3715,2798
307,4,1,1,1,38,0,6,3833,2789,20,-1,,5,3853,2795
308,5,1,1,1,38,1,6,3833,12,20,20,7,5,3853,18
309,5,1,1,1,38,2,2332,3841,71,12,62,ama,5,3853,2403
310,5,1,1,1,38,3,2663,3841,45,12,0,—a,5,3853,2708
311,5,1,1,1,38,4,2728,3843,67,10,12,Fad,5,3853,2795
0,1,1,0,0,0,0,0,0,3106,3853,-1,,6,3853,3106
1,2,1,1,0,0,0,0,48,2836,3805,-1,,6,3853,2836
2,3,1,1,1,0,0,0,48,2836,3691,-1,,6,3739,2836
3,4,1,1,1,1,0,2213,48,622,47,-1,,6,95,2835
4,5,1,1,1,1,1,2213,48,223,39,91,Castlemore,6,87,2436
5,5,1,1,1,1,2,2454,52,141,43,93,Ranger,6,95,2595
6,5,1,1,1,1,3,2609,52,57,41,0,(3),6,93,2666
7,5,1,1,1,1,4,2682,52,153,35,94,Limited,6,87,2835
8,4,1,1,1,2,0,2015,111,821,47,-1,,6,158,2836
9,5,1,1,1,2,1,2015,111,190,35,92,Directors,6,146,2205
10,5,1,1,1,2,2,2223,121,115,37,95,report,6,158,2338
11,5,1,1,1,2,3,2354,115,69,35,95,and,6,150,2423
12,5,1,1,1,2,4,2440,113,171,35,96,financial,6,148,2611
13,5,1,1,1,2,5,2628,121,208,27,96,statements,6,148,2836
14,4,1,1,1,3,0,2066,170,768,45,-1,,6,215,2834
15,5,1,1,1,3,1,2066,170,69,35,96,For,6,205,2135
16,5,1,1,1,3,2,2149,170,54,33,96,the,6,203,2203
17,5,1,1,1,3,3,2217,179,80,34,96,year,6,213,2297
18,5,1,1,1,3,4,2311,172,118,35,96,ended,6,207,2429
19,5,1,1,1,3,5,2447,170,48,37,95,30,6,207,2495
20,5,1,1,1,3,6,2511,170,211,45,96,September,6,215,2722
21,5,1,1,1,3,7,2736,170,98,37,96,2007,6,207,2834
22,4,1,1,1,4,0,245,324,467,61,-1,,6,385,712
23,5,1,1,1,4,1,245,324,167,51,96,Notes,6,375,412
24,5,1,1,1,4,2,434,334,278,51,96,(continued),6,385,712
25,4,1,1,1,5,0,243,468,365,41,-1,,6,509,608
26,5,1,1,1,5,1,243,468,26,39,97,6,6,507,269
27,5,1,1,1,5,2,400,468,208,41,96,Taxation,6,509,608
28,4,1,1,1,6,0,243,624,900,53,-1,,6,677,1143
29,5,1,1,1,6,1,261,626,31,47,0,),6,673,292
30,5,1,1,1,6,2,437,626,193,49,94,Analysis,6,675,630
31,5,1,1,1,6,3,647,626,53,51,95,of,6,677,700
32,5,1,1,1,6,4,707,626,156,49,96,charge,6,675,863
33,5,1,1,1,6,5,869,624,78,51,96,for,6,675,947
34,5,1,1,1,6,6,959,626,70,38,96,the,6,664,1029
35,5,1,1,1,6,7,1039,638,104,37,96,year,6,675,1143
36,4,1,1,1,7,0,2298,683,497,54,-1,,6,737,2795
37,5,1,1,1,7,1,2298,683,99,54,96,2007,6,737,2397
38,5,1,1,1,7,2,2695,685,100,37,96,2006,6,722,2795
39,4,1,1,1,8,0,2374,750,419,37,-1,,6,787,2793
40,5,1,1,1,8,1,2374,752,23,35,92,£,6,787,2397
41,5,1,1,1,8,2,2771,750,22,35,92,£,6,785,2793
42,4,1,1,1,9,0,247,809,380,45,-1,,6,854,627
43,5,1,1,1,9,1,247,809,65,35,96,UK,6,844,312
44,5,1,1,1,9,2,324,818,229,36,94,corporation,6,854,553
45,5,1,1,1,9,3,569,818,58,26,94,tax,6,844,627
46,4,1,1,1,10,0,243,865,2552,48,-1,,6,913,2795
47,5,1,1,1,10,1,243,867,145,36,96,Current,6,903,388
48,5,1,1,1,10,2,404,875,55,28,96,tax,6,903,459
49,5,1,1,1,10,3,475,878,45,25,95,on,6,903,520
50,5,1,1,1,10,4,535,879,142,25,95,income,6,904,677
51,5,1,1,1,10,5,691,869,54,36,96,for,6,905,745
52,5,1,1,1,10,6,757,867,58,36,96,the,6,903,815
53,5,1,1,1,10,7,829,877,81,36,96,year,6,913,910
54,5,1,1,1,10,8,2285,868,112,43,0,6572,6,911,2397
55,5,1,1,1,10,9,2630,866,67,35,93,941,6,901,2697
56,5,1,1,1,10,10,2719,865,76,38,93,630,6,903,2795
57,4,1,1,1,11,0,243,1018,2550,46,-1,,6,1064,2793
58,5,1,1,1,11,1,243,1020,100,36,96,Total,6,1056,343
59,5,1,1,1,11,2,355,1027,135,29,96,current,6,1056,490
60,5,1,1,1,11,3,506,1028,55,28,96,tax,6,1056,561
61,5,1,1,1,11,4,577,1021,66,35,96,and,6,1056,643
62,5,1,1,1,11,5,659,1028,55,28,95,tax,6,1056,714
63,5,1,1,1,11,6,729,1030,46,26,95,on,6,1056,775
64,5,1,1,1,11,7,791,1018,104,45,96,profit,6,1063,895
65,5,1,1,1,11,8,908,1030,48,24,96,on,6,1054,956
66,5,1,1,1,11,9,971,1020,162,44,96,ordinary,6,1064,1133
67,5,1,1,1,11,10,1145,1026,170,30,96,activities,6,1056,1315
68,5,1,1,1,11,11,2284,1020,113,43,0,6572,6,1063,2397
69,5,1,1,1,11,12,2630,1018,163,39,0,941630,6,1057,2793
70,4,1,1,1,12,0,243,1208,1347,51,-1,,6,1259,1590
71,5,1,1,1,12,1,243,1209,65,47,56,(i),6,1256,308
72,5,1,1,1,12,2,401,1210,172,40,77,Factors,6,1250,573
73,5,1,1,1,12,3,586,1210,204,49,39,affecting,6,1259,790
74,5,1,1,1,12,4,806,1208,68,40,96,the,6,1248,874
75,5,1,1,1,12,5,890,1214,71,34,96,tax,6,1248,961
76,5,1,1,1,12,6,976,1208,155,49,96,charge,6,1257,1131
77,5,1,1,1,12,7,1137,1208,77,51,95,for,6,1259,1214
78,5,1,1,1,12,8,1227,1208,67,40,95,the,6,1248,1294
79,5,1,1,1,12,9,1311,1216,167,32,96,current,6,1248,1478
80,5,1,1,1,12,10,1488,1222,102,37,96,year,6,1259,1590
81,4,1,1,1,13,0,243,1306,2583,53,-1,,6,1359,2826
82,5,1,1,1,13,1,243,1308,83,38,96,The,6,1346,326
83,5,1,1,1,13,2,347,1316,153,32,96,current,6,1348,500
84,5,1,1,1,13,3,524,1316,62,32,96,tax,6,1348,586
85,5,1,1,1,13,4,610,1308,144,51,96,charge,6,1359,754
86,5,1,1,1,13,5,778,1306,61,40,96,for,6,1346,839
87,5,1,1,1,13,6,861,1306,62,40,96,the,6,1346,923
88,5,1,1,1,13,7,947,1318,92,37,96,year,6,1355,1039
89,5,1,1,1,13,8,1063,1318,31,28,96,1s,6,1346,1094
90,5,1,1,1,13,9,1116,1307,115,50,95,equal,6,1357,1231
91,5,1,1,1,13,10,1255,1316,39,30,96,to,6,1346,1294
92,5,1,1,1,13,11,1315,1306,128,48,73,(2006,6,1354,1443
93,5,1,1,1,13,12,1482,1308,145,49,0,fuigher,6,1357,1627
94,5,1,1,1,13,13,1647,1306,115,47,94,than),6,1353,1762
95,5,1,1,1,13,14,1784,1306,62,40,95,the,6,1346,1846
96,5,1,1,1,13,15,1870,1306,182,40,96,standard,6,1346,2052
97,5,1,1,1,13,16,2074,1314,82,32,96,rate,6,1346,2156
98,5,1,1,1,13,17,2178,1306,43,40,96,of,6,1346,2221
99,5,1,1,1,13,18,2236,1316,253,41,96,corporation,6,1357,2489
100,5,1,1,1,13,19,2513,1314,64,30,96,tax,6,1344,2577
101,5,1,1,1,13,20,2601,1318,37,26,96,in,6,1344,2638
102,5,1,1,1,13,21,2662,1306,64,38,96,the,6,1344,2726
103,5,1,1,1,13,22,2748,1306,78,40,96,UK,6,1346,2826
104,4,1,1,1,14,0,243,1371,1274,49,-1,,6,1420,1517
105,5,1,1,1,14,1,243,1371,116,47,91,(30,6,1418,359
106,5,1,1,1,14,2,377,1371,127,47,92,(2006,6,1418,504
107,5,1,1,1,14,3,538,1371,137,49,0,309)),6,1420,675
108,5,1,1,1,14,4,718,1373,84,37,96,The,6,1410,802
109,5,1,1,1,14,5,820,1371,241,39,96,differences,6,1410,1061
110,5,1,1,1,14,6,1078,1383,64,27,96,are,6,1410,1142
111,5,1,1,1,14,7,1159,1371,209,49,95,explained,6,1420,1368
112,5,1,1,1,14,8,1386,1373,131,37,95,below,6,1410,1517
113,4,1,1,1,15,0,2297,1425,494,57,-1,,6,1482,2791
114,5,1,1,1,15,1,2297,1434,98,35,96,2007,6,1469,2395
115,5,1,1,1,15,2,2695,1425,96,57,96,2006,6,1482,2791
116,4,1,1,1,16,0,2374,1489,417,39,-1,,6,1528,2791
117,5,1,1,1,16,1,2374,1493,23,35,90,£,6,1528,2397
118,5,1,1,1,16,2,2770,1489,21,35,91,£,6,1524,2791
119,4,1,1,1,17,0,247,1550,502,35,-1,,6,1585,749
120,5,1,1,1,17,1,247,1550,149,35,96,Current,6,1585,396
121,5,1,1,1,17,2,410,1558,59,27,90,tax,6,1585,469
122,5,1,1,1,17,3,481,1550,268,35,70,reconcilianon,6,1585,749
123,4,1,1,1,18,0,246,1606,2546,47,-1,,6,1653,2792
124,5,1,1,1,18,1,246,1608,107,36,96,Profit,6,1644,353
125,5,1,1,1,18,2,367,1618,45,26,95,on,6,1644,412
126,5,1,1,1,18,3,428,1609,162,44,95,ordinary,6,1653,590
127,5,1,1,1,18,4,603,1616,170,28,95,activities,6,1644,773
128,5,1,1,1,18,5,788,1606,121,36,96,before,6,1642,909
129,5,1,1,1,18,6,922,1614,56,28,96,tax,6,1642,978
130,5,1,1,1,18,7,2260,1608,43,36,0,21,6,1644,2303
131,5,1,1,1,18,8,2314,1608,83,43,0,905,6,1651,2397
132,5,1,1,1,18,9,2600,1606,105,38,0,1202,6,1644,2705
133,5,1,1,1,18,10,2721,1606,71,36,96,297,6,1642,2792
134,4,1,1,1,19,0,245,1757,2548,45,-1,,6,1802,2793
135,5,1,1,1,19,1,245,1759,145,36,96,Current,6,1795,390
136,5,1,1,1,19,2,404,1767,55,28,96,tax,6,1795,459
137,5,1,1,1,19,3,475,1767,31,28,92,at,6,1795,506
138,5,1,1,1,19,4,522,1759,86,38,92,30,6,1797,608
139,5,1,1,1,19,5,622,1761,113,41,92,(2006,6,1802,735
140,5,1,1,1,19,6,763,1759,104,41,0,30),6,1800,867
141,5,1,1,1,19,7,2285,1759,112,43,0,6572,6,1802,2397
142,5,1,1,1,19,8,2632,1757,75,36,96,360,6,1793,2707
143,5,1,1,1,19,9,2719,1757,74,36,96,689,6,1793,2793
144,4,1,1,1,20,0,245,1877,187,45,-1,,6,1922,432
145,5,1,1,1,20,1,245,1877,128,45,96,Effects,6,1922,373
146,5,1,1,1,20,2,387,1878,45,44,96,of,6,1922,432
147,4,1,1,1,21,0,244,1934,2541,47,-1,,6,1981,2785
148,5,1,1,1,21,1,244,1936,121,45,96,Group,6,1981,365
149,5,1,1,1,21,2,381,1936,102,35,94,relief,6,1971,483
150,5,1,1,1,21,3,492,1938,161,33,85,received,6,1971,653
151,5,1,1,1,21,4,667,1944,33,27,96,at,6,1971,700
152,5,1,1,1,21,5,712,1936,164,36,96,different,6,1972,876
153,5,1,1,1,21,6,890,1942,71,29,96,rate,6,1971,961
154,5,1,1,1,21,7,974,1936,81,35,93,than,6,1971,1055
155,5,1,1,1,21,8,1071,1936,86,35,0,30,6,1971,1157
156,5,1,1,1,21,9,2383,1955,14,8,46,-,6,1963,2397
157,5,1,1,1,21,10,2632,1934,75,35,95,580,6,1969,2707
158,5,1,1,1,21,11,2719,1934,66,35,92,941,6,1969,2785
159,4,1,1,1,22,0,243,2085,2550,49,-1,,6,2134,2793
160,5,1,1,1,22,1,243,2089,102,33,95,Total,6,2122,345
161,5,1,1,1,22,2,360,2095,138,27,96,current,6,2122,498
162,5,1,1,1,22,3,516,2095,55,27,96,tax,6,2122,571
163,5,1,1,1,22,4,586,2089,132,45,96,charge,6,2134,718
164,5,1,1,1,22,5,2284,2089,113,41,0,6572,6,2130,2397
165,5,1,1,1,22,6,2630,2085,67,35,95,941,6,2120,2697
166,5,1,1,1,22,7,2719,2085,74,35,95,630,6,2120,2793
167,4,1,1,1,23,0,243,2273,1157,51,-1,,6,2324,1400
168,5,1,1,1,23,1,243,2275,79,47,68,(ui),6,2322,322
169,5,1,1,1,23,2,441,2275,171,39,96,Factors,6,2314,612
170,5,1,1,1,23,3,630,2275,88,39,96,that,6,2314,718
171,5,1,1,1,23,4,732,2287,95,37,96,may,6,2324,827
172,5,1,1,1,23,5,841,2273,131,51,96,affect,6,2324,972
173,5,1,1,1,23,6,978,2275,147,49,96,future,6,2324,1125
174,5,1,1,1,23,7,1141,2281,69,33,95,tax,6,2314,1210
175,5,1,1,1,23,8,1225,2275,175,49,96,charges,6,2324,1400
176,4,1,1,1,24,0,243,2373,1725,51,-1,,6,2424,1968
177,5,1,1,1,24,1,243,2373,84,39,93,The,6,2412,327
178,5,1,1,1,24,2,343,2383,251,41,15,corporanion,6,2424,594
179,5,1,1,1,24,3,614,2383,62,29,96,tax,6,2412,676
180,5,1,1,1,24,4,694,2383,80,29,96,rate,6,2412,774
181,5,1,1,1,24,5,793,2385,32,25,92,1s,6,2410,825
182,5,1,1,1,24,6,841,2373,77,37,96,due,6,2410,918
183,5,1,1,1,24,7,937,2381,39,29,95,to,6,2410,976
184,5,1,1,1,24,8,992,2373,152,49,96,change,6,2422,1144
185,5,1,1,1,24,9,1163,2373,101,39,93,from,6,2412,1264
186,5,1,1,1,24,10,1282,2373,96,39,90,30,6,2412,1378
187,5,1,1,1,24,11,1396,2381,39,31,93,to,6,2412,1435
188,5,1,1,1,24,12,1453,2373,98,39,92,28,6,2412,1551
189,5,1,1,1,24,13,1569,2373,101,39,96,from,6,2412,1670
190,5,1,1,1,24,14,1696,2373,9,37,0,1,6,2410,1705
191,5,1,1,1,24,15,1731,2373,112,49,95,April,6,2422,1843
192,5,1,1,1,24,16,1862,2373,106,37,96,2008,6,2410,1968
193,4,1,1,1,25,0,247,2498,304,60,-1,,6,2558,551
194,5,1,1,1,25,1,247,2502,24,39,95,7,6,2541,271
195,5,1,1,1,25,2,400,2498,151,60,96,Stocks,6,2558,551
196,4,1,1,1,26,0,2299,2598,496,37,-1,,6,2635,2795
197,5,1,1,1,26,1,2299,2600,100,35,96,2007,6,2635,2399
198,5,1,1,1,26,2,2697,2598,98,35,96,2006,6,2633,2795
199,4,1,1,1,27,0,2381,2655,419,37,-1,,6,2692,2800
200,5,1,1,1,27,1,2381,2657,24,35,92,£,6,2692,2405
201,5,1,1,1,27,2,2778,2655,22,35,92,£,6,2690,2800
202,4,1,1,1,28,0,246,2771,2553,47,-1,,6,2818,2799
203,5,1,1,1,28,1,246,2773,107,35,93,Work,6,2808,353
204,5,1,1,1,28,2,367,2784,33,24,85,1n,6,2808,400
205,5,1,1,1,28,3,417,2782,160,36,96,progress,6,2818,577
206,5,1,1,1,28,4,2244,2773,160,43,0,230554,6,2816,2404
207,5,1,1,1,28,5,2664,2771,135,37,0,30137,6,2808,2799
208,4,1,1,1,29,0,245,2986,339,61,-1,,6,3047,584
209,5,1,1,1,29,1,245,2990,26,41,96,8,6,3031,271
210,5,1,1,1,29,2,401,2986,183,61,96,Debtors,6,3047,584
211,4,1,1,1,30,0,2299,3086,496,39,-1,,6,3125,2795
212,5,1,1,1,30,1,2299,3088,98,37,96,2007,6,3125,2397
213,5,1,1,1,30,2,2695,3086,100,36,96,2006,6,3122,2795
214,4,1,1,1,31,0,2381,3143,418,39,-1,,6,3182,2799
215,5,1,1,1,31,1,2381,3147,24,35,92,£,6,3182,2405
216,5,1,1,1,31,2,2777,3143,22,35,70,£,6,3178,2799
217,4,1,1,1,32,0,247,3259,2552,49,-1,,6,3308,2799
218,5,1,1,1,32,1,247,3263,173,35,96,Amounts,6,3298,420
219,5,1,1,1,32,2,434,3263,103,35,96,owed,6,3298,537
220,5,1,1,1,32,3,549,3263,47,45,96,by,6,3308,596
221,5,1,1,1,32,4,611,3272,113,36,96,group,6,3308,724
222,5,1,1,1,32,5,736,3261,250,45,96,undertakings,6,3306,986
223,5,1,1,1,32,6,2216,3263,191,41,0,1058768,6,3304,2407
224,5,1,1,1,32,7,2606,3259,193,38,0,1251979,6,3297,2799
225,4,1,1,1,33,0,247,3319,2554,44,-1,,6,3363,2801
226,5,1,1,1,33,1,247,3319,108,38,96,Other,6,3357,355
227,5,1,1,1,33,2,367,3321,141,36,96,debtors,6,3357,508
228,5,1,1,1,33,3,2268,3321,139,42,0,30782,6,3363,2407
229,5,1,1,1,33,4,2666,3319,135,38,0,21137,6,3357,2801
230,4,1,1,1,34,0,2217,3470,586,47,-1,,6,3517,2803
231,5,1,1,1,34,1,2217,3472,190,45,0,1089550,6,3517,2407
232,5,1,1,1,34,2,2608,3472,10,34,94,1,6,3506,2618
233,5,1,1,1,34,3,2642,3470,71,36,85,273,6,3506,2713
234,5,1,1,1,34,4,2734,3470,69,36,85,116,6,3506,2803
235,4,1,1,1,35,0,247,3661,1958,52,-1,,6,3713,2205
236,5,1,1,1,35,1,247,3664,194,38,96,Amounts,6,3702,441
237,5,1,1,1,35,2,459,3664,116,38,96,owed,6,3702,575
238,5,1,1,1,35,3,592,3664,53,49,95,by,6,3713,645
239,5,1,1,1,35,4,661,3674,125,39,95,group,6,3713,786
240,5,1,1,1,35,5,806,3661,278,51,95,undertakings,6,3712,1084
241,5,1,1,1,35,6,1104,3663,156,39,95,include,6,3702,1260
242,5,1,1,1,35,7,1278,3663,143,50,95,unpaid,6,3713,1421
243,5,1,1,1,35,8,1439,3663,114,39,96,share,6,3702,1553
244,5,1,1,1,35,9,1568,3663,145,50,96,capital,6,3713,1713
245,5,1,1,1,35,10,1731,3661,49,39,96,of,6,3700,1780
246,5,1,1,1,35,11,1790,3661,109,41,95,£900,6,3702,1899
247,5,1,1,1,35,12,1917,3661,125,48,95,(2006,6,3709,2042
248,5,1,1,1,35,13,2076,3661,129,48,96,£900),6,3709,2205
0,1,1,0,0,0,0,0,0,3106,3853,-1,,7,3853,3106
1,2,1,1,0,0,0,0,55,2834,3519,-1,,7,3574,2834
2,3,1,1,1,0,0,0,55,2834,3519,-1,,7,3574,2834
3,4,1,1,1,1,0,2212,55,622,45,-1,,7,100,2834
4,5,1,1,1,1,1,2212,55,225,37,92,Castlemore,7,92,2437
5,5,1,1,1,1,2,2454,55,141,45,96,Ranger,7,100,2595
6,5,1,1,1,1,3,2609,57,55,41,95,(3),7,98,2664
7,5,1,1,1,1,4,2680,57,154,35,92,Limited,7,92,2834
8,4,1,1,1,2,0,2014,117,820,45,-1,,7,162,2834
9,5,1,1,1,2,1,2014,117,178,36,90,Directors,7,153,2192
10,5,1,1,1,2,2,2222,125,118,37,96,report,7,162,2340
11,5,1,1,1,2,3,2357,119,68,34,95,and,7,153,2425
12,5,1,1,1,2,4,2441,117,170,36,95,financial,7,153,2611
13,5,1,1,1,2,5,2629,125,205,28,95,statements,7,153,2834
14,4,1,1,1,3,0,2069,174,765,47,-1,,7,221,2834
15,5,1,1,1,3,1,2069,174,66,36,96,For,7,210,2135
16,5,1,1,1,3,2,2147,176,55,34,96,the,7,210,2202
17,5,1,1,1,3,3,2216,186,85,33,96,year,7,219,2301
18,5,1,1,1,3,4,2313,176,118,35,95,ended,7,211,2431
19,5,1,1,1,3,5,2448,175,50,36,95,30,7,211,2498
20,5,1,1,1,3,6,2511,176,214,45,96,September,7,221,2725
21,5,1,1,1,3,7,2739,176,95,35,96,2007,7,211,2834
22,4,1,1,1,4,0,248,329,465,61,-1,,7,390,713
23,5,1,1,1,4,1,248,329,168,51,95,Notes,7,380,416
24,5,1,1,1,4,2,439,337,274,53,95,(continued),7,390,713
25,4,1,1,1,5,0,247,603,1269,51,-1,,7,654,1516
26,5,1,1,1,5,1,247,603,26,39,96,9,7,642,273
27,5,1,1,1,5,2,406,603,237,39,92,Creditors,7,642,643
28,5,1,1,1,5,3,661,605,209,37,96,Amounts,7,642,870
29,5,1,1,1,5,4,888,603,147,51,95,falling,7,654,1035
30,5,1,1,1,5,5,1050,603,84,39,96,due,7,642,1134
31,5,1,1,1,5,6,1152,603,147,39,96,within,7,642,1299
32,5,1,1,1,5,7,1317,616,80,26,96,one,7,642,1397
33,5,1,1,1,5,8,1413,615,103,37,96,year,7,652,1516
34,4,1,1,1,6,0,2302,694,491,58,-1,,7,752,2793
35,5,1,1,1,6,1,2302,694,96,58,96,2007,7,752,2398
36,5,1,1,1,6,2,2694,699,99,36,96,2006,7,735,2793
37,4,1,1,1,7,0,2382,758,417,37,-1,,7,795,2799
38,5,1,1,1,7,1,2382,760,23,35,92,£,7,795,2405
39,5,1,1,1,7,2,2776,758,23,35,89,£,7,793,2799
40,4,1,1,1,8,0,248,873,2551,38,-1,,7,911,2799
41,5,1,1,1,8,1,248,873,99,36,96,Bank,7,909,347
42,5,1,1,1,8,2,363,873,179,36,96,overdraft,7,909,542
43,5,1,1,1,8,3,2390,895,14,6,89,-,7,901,2404
44,5,1,1,1,8,4,2688,873,111,38,39,7878,7,911,2799
45,4,1,1,1,9,0,245,930,2552,45,-1,,7,975,2797
46,5,1,1,1,9,1,245,932,112,33,96,Trade,7,965,357
47,5,1,1,1,9,2,369,932,168,33,96,creditors,7,965,537
48,5,1,1,1,9,3,2271,932,133,43,0,12183,7,975,2404
49,5,1,1,1,9,4,2668,930,41,35,92,12,7,965,2709
50,5,1,1,1,9,5,2727,930,70,35,92,273,7,965,2797
51,4,1,1,1,10,0,245,989,2554,44,-1,,7,1033,2799
52,5,1,1,1,10,1,245,989,110,37,96,Other,7,1026,355
53,5,1,1,1,10,2,367,991,168,35,96,creditors,7,1026,535
54,5,1,1,1,10,3,2266,991,131,42,0,74723,7,1033,2397
55,5,1,1,1,10,4,2662,990,45,34,96,65,7,1024,2707
56,5,1,1,1,10,5,2727,989,72,35,96,237,7,1024,2799
57,4,1,1,1,11,0,0,1137,2799,177,-1,,7,1314,2799
58,5,1,1,1,11,1,0,1189,15,125,0,),7,1314,15
59,5,1,1,1,11,2,2265,1137,139,58,0,86906,7,1195,2404
60,5,1,1,1,11,3,2662,1142,45,35,95,85,7,1177,2707
61,5,1,1,1,11,4,2725,1142,74,35,95,388,7,1177,2799
62,4,1,1,1,12,0,250,1361,690,49,-1,,7,1410,940
63,5,1,1,1,12,1,250,1361,50,39,95,10,7,1400,300
64,5,1,1,1,12,2,404,1361,149,39,90,Called,7,1400,553
65,5,1,1,1,12,3,570,1375,57,35,96,up,7,1410,627
66,5,1,1,1,12,4,643,1361,126,39,96,share,7,1400,769
67,5,1,1,1,12,5,786,1361,154,49,96,capital,7,1410,940
68,4,1,1,1,13,0,2306,1450,493,58,-1,,7,1508,2799
69,5,1,1,1,13,1,2306,1459,98,35,96,2007,7,1494,2404
70,5,1,1,1,13,2,2701,1450,98,58,96,2006,7,1508,2799
71,4,1,1,1,14,0,2380,1514,419,37,-1,,7,1551,2799
72,5,1,1,1,14,1,2380,1516,24,35,92,£,7,1551,2404
73,5,1,1,1,14,2,2778,1514,21,35,87,£,7,1549,2799
74,4,1,1,1,15,0,241,1573,226,35,-1,,7,1608,467
75,5,1,1,1,15,1,241,1573,226,35,95,Authorised,7,1608,467
76,4,1,1,1,16,0,245,1623,2550,58,-1,,7,1681,2795
77,5,1,1,1,16,1,245,1631,173,45,96,Ordinary,7,1676,418
78,5,1,1,1,16,2,433,1631,118,36,97,shares,7,1667,551
79,5,1,1,1,16,3,564,1631,42,36,96,of,7,1667,606
80,5,1,1,1,16,4,613,1631,41,36,96,£1,7,1667,654
81,5,1,1,1,16,5,674,1631,86,36,96,each,7,1667,760
82,5,1,1,1,16,6,2296,1631,109,43,0,1000,7,1674,2405
83,5,1,1,1,16,7,2692,1623,103,58,0,1000,7,1681,2795
84,4,1,1,1,17,0,241,1782,437,45,-1,,7,1827,678
85,5,1,1,1,17,1,241,1782,159,35,92,Allotted,7,1817,400
86,5,1,1,1,17,2,410,1782,80,35,96,and,7,1817,490
87,5,1,1,1,17,3,500,1782,119,35,95,called,7,1817,619
88,5,1,1,1,17,4,629,1794,49,33,96,up,7,1827,678
89,4,1,1,1,18,0,245,1840,2553,46,-1,,7,1886,2798
90,5,1,1,1,18,1,245,1841,173,45,96,Ordinary,7,1886,418
91,5,1,1,1,18,2,431,1841,120,35,96,shares,7,1876,551
92,5,1,1,1,18,3,563,1843,36,33,94,of,7,1876,599
93,5,1,1,1,18,4,613,1841,41,35,95,£1,7,1876,654
94,5,1,1,1,18,5,674,1841,84,35,96,each,7,1876,758
95,5,1,1,1,18,6,2331,1841,73,35,94,900,7,1876,2404
96,5,1,1,1,18,7,2725,1840,73,36,96,900,7,1876,2798
97,4,1,1,1,19,0,250,2054,396,59,-1,,7,2113,646
98,5,1,1,1,19,1,250,2060,41,37,87,11,7,2097,291
99,5,1,1,1,19,2,443,2054,203,59,96,Reserves,7,2113,646
100,4,1,1,1,20,0,2586,2156,213,35,-1,,7,2191,2799
101,5,1,1,1,20,1,2586,2156,120,35,96,Profit,7,2191,2706
102,5,1,1,1,20,2,2721,2156,78,35,96,and,7,2191,2799
103,4,1,1,1,21,0,2546,2213,253,35,-1,,7,2248,2799
104,5,1,1,1,21,1,2546,2213,75,35,96,loss,7,2248,2621
105,5,1,1,1,21,2,2635,2217,164,31,96,account,7,2248,2799
106,4,1,1,1,22,0,2776,2270,23,35,-1,,7,2305,2799
107,5,1,1,1,22,1,2776,2270,23,35,91,£,7,2305,2799
108,4,1,1,1,23,0,245,2385,2552,47,-1,,7,2432,2797
109,5,1,1,1,23,1,245,2387,45,34,96,At,7,2421,290
110,5,1,1,1,23,2,304,2387,194,45,96,beginning,7,2432,498
111,5,1,1,1,23,3,512,2385,41,37,96,of,7,2422,553
112,5,1,1,1,23,4,563,2397,80,33,97,year,7,2430,643
113,5,1,1,1,23,5,2604,2385,193,39,0,1216965,7,2424,2797
114,4,1,1,1,24,0,245,2444,2552,45,-1,,7,2489,2797
115,5,1,1,1,24,1,245,2446,107,35,96,Profit,7,2481,352
116,5,1,1,1,24,2,369,2445,52,36,96,for,7,2481,421
117,5,1,1,1,24,3,435,2446,57,33,96,the,7,2479,492
118,5,1,1,1,24,4,508,2446,160,33,94,financial,7,2479,668
119,5,1,1,1,24,5,684,2456,80,33,96,year,7,2489,764
120,5,1,1,1,24,6,2668,2444,129,39,0,15333,7,2483,2797
121,4,1,1,1,25,0,244,2597,2554,45,-1,,7,2642,2798
122,5,1,1,1,25,1,244,2599,50,33,96,At,7,2632,294
123,5,1,1,1,25,2,308,2599,72,34,96,end,7,2633,380
124,5,1,1,1,25,3,394,2598,41,34,96,of,7,2632,435
125,5,1,1,1,25,4,445,2609,92,33,96,year,7,2642,537
126,5,1,1,1,25,5,2602,2597,196,43,0,1232298,7,2640,2798
127,4,1,1,1,26,0,250,2816,1108,49,-1,,7,2865,1358
128,5,1,1,1,26,1,250,2816,45,37,95,12,7,2853,295
129,5,1,1,1,26,2,402,2816,247,39,96,Immediate,7,2855,649
130,5,1,1,1,26,3,666,2816,85,39,96,and,7,2855,751
131,5,1,1,1,26,4,768,2816,192,37,95,ultimate,7,2853,960
132,5,1,1,1,26,5,976,2820,154,45,96,parent,7,2865,1130
133,5,1,1,1,26,6,1146,2828,212,37,95,company,7,2865,1358
134,4,1,1,1,27,0,243,2949,2305,51,-1,,7,3000,2548
135,5,1,1,1,27,1,243,2949,84,40,95,The,7,2989,327
136,5,1,1,1,27,2,345,2949,227,40,94,immediate,7,2989,572
137,5,1,1,1,27,3,590,2957,132,43,95,parent,7,3000,722
138,5,1,1,1,27,4,739,2961,198,39,95,company,7,3000,937
139,5,1,1,1,27,5,954,2961,32,28,65,is,7,2989,986
140,5,1,1,1,27,6,1003,2949,248,40,92,Castlemore,7,2989,1251
141,5,1,1,1,27,7,1270,2949,156,49,94,Ranger,7,2998,1426
142,5,1,1,1,27,8,1442,2949,61,47,93,(1),7,2996,1503
143,5,1,1,1,27,9,1521,2949,179,44,91,Limited,7,2993,1700
144,5,1,1,1,27,10,1720,2949,128,38,96,which,7,2987,1848
145,5,1,1,1,27,11,1867,2961,31,26,96,1s,7,2987,1898
146,5,1,1,1,27,12,1916,2949,278,49,93,incorporated,7,2998,2194
147,5,1,1,1,27,13,2214,2961,34,26,82,1n,7,2987,2248
148,5,1,1,1,27,14,2263,2949,119,40,96,Great,7,2989,2382
149,5,1,1,1,27,15,2402,2949,146,39,51,Britain,7,2988,2548
150,4,1,1,1,28,0,243,3047,2581,51,-1,,7,3098,2824
151,5,1,1,1,28,1,243,3049,84,37,92,The,7,3086,327
152,5,1,1,1,28,2,351,3049,176,37,57,ultamate,7,3086,527
153,5,1,1,1,28,3,549,3057,134,41,96,parent,7,3098,683
154,5,1,1,1,28,4,704,3061,195,37,96,company,7,3098,899
155,5,1,1,1,28,5,921,3061,33,26,93,1s,7,3087,954
156,5,1,1,1,28,6,976,3049,247,37,92,Castlemore,7,3086,1223
157,5,1,1,1,28,7,1246,3048,139,50,96,Group,7,3098,1385
158,5,1,1,1,28,8,1407,3049,195,49,91,Holdings,7,3098,1602
159,5,1,1,1,28,9,1626,3049,180,45,70,Limited,7,3094,1806
160,5,1,1,1,28,10,1830,3049,130,37,94,which,7,3086,1960
161,5,1,1,1,28,11,1982,3061,34,25,76,1s,7,3086,2016
162,5,1,1,1,28,12,2037,3049,270,49,96,incorporated,7,3098,2307
163,5,1,1,1,28,13,2330,3061,39,25,93,in,7,3086,2369
164,5,1,1,1,28,14,2392,3047,119,39,96,Great,7,3086,2511
165,5,1,1,1,28,15,2533,3049,149,37,66,Britain,7,3086,2682
166,5,1,1,1,28,16,2738,3049,86,37,77,The,7,3086,2824
167,4,1,1,1,29,0,245,3112,2580,51,-1,,7,3163,2825
168,5,1,1,1,29,1,245,3114,93,49,96,only,7,3163,338
169,5,1,1,1,29,2,365,3126,127,37,95,group,7,3163,492
170,5,1,1,1,29,3,518,3126,39,25,95,in,7,3151,557
171,5,1,1,1,29,4,584,3114,127,37,96,which,7,3151,711
172,5,1,1,1,29,5,738,3114,61,37,96,the,7,3151,799
173,5,1,1,1,29,6,827,3112,139,39,94,results,7,3151,966
174,5,1,1,1,29,7,991,3112,49,39,96,of,7,3151,1040
175,5,1,1,1,29,8,1061,3113,62,38,96,the,7,3151,1123
176,5,1,1,1,29,9,1150,3124,200,39,96,company,7,3163,1350
177,5,1,1,1,29,10,1377,3124,63,27,96,are,7,3151,1440
178,5,1,1,1,29,11,1467,3113,275,38,67,consolidated,7,3151,1742
179,5,1,1,1,29,12,1769,3124,31,27,90,1s,7,3151,1800
180,5,1,1,1,29,13,1828,3113,78,38,96,that,7,3151,1906
181,5,1,1,1,29,14,1933,3112,153,39,96,headed,7,3151,2086
182,5,1,1,1,29,15,2112,3112,55,49,92,by,7,3161,2167
183,5,1,1,1,29,16,2190,3112,241,39,90,Castlemore,7,3151,2431
184,5,1,1,1,29,17,2458,3112,139,51,96,Group,7,3163,2597
185,5,1,1,1,29,18,2623,3113,202,50,96,Holdings,7,3163,2825
186,4,1,1,1,30,0,245,3177,2578,50,-1,,7,3227,2823
187,5,1,1,1,30,1,245,3177,169,39,92,Limited,7,3216,414
188,5,1,1,1,30,2,470,3177,83,39,92,The,7,3216,553
189,5,1,1,1,30,3,576,3177,272,39,96,consolidated,7,3216,848
190,5,1,1,1,30,4,872,3177,186,39,96,financial,7,3216,1058
191,5,1,1,1,30,5,1083,3185,229,31,95,statements,7,3216,1312
192,5,1,1,1,30,6,1334,3177,47,39,93,of,7,3216,1381
193,5,1,1,1,30,7,1399,3177,245,39,91,Castlemore,7,3216,1644
194,5,1,1,1,30,8,1667,3177,137,50,96,Group,7,3227,1804
195,5,1,1,1,30,9,1827,3177,199,48,95,Holdings,7,3225,2026
196,5,1,1,1,30,10,2048,3177,169,39,74,Limited,7,3216,2217
197,5,1,1,1,30,11,2239,3188,60,28,96,are,7,3216,2299
198,5,1,1,1,30,12,2319,3177,198,39,95,available,7,3216,2517
199,5,1,1,1,30,13,2539,3184,41,32,94,to,7,3216,2580
200,5,1,1,1,30,14,2601,3178,63,38,94,the,7,3216,2664
201,5,1,1,1,30,15,2688,3177,135,50,96,public,7,3227,2823
202,4,1,1,1,31,0,245,3241,572,49,-1,,7,3290,817
203,5,1,1,1,31,1,245,3241,75,39,96,and,7,3280,320
204,5,1,1,1,31,2,339,3253,90,37,96,may,7,3290,429
205,5,1,1,1,31,3,445,3241,50,39,96,be,7,3280,495
206,5,1,1,1,31,4,512,3241,186,39,96,obtained,7,3280,698
207,5,1,1,1,31,5,716,3241,101,39,96,from,7,3280,817
208,4,1,1,1,32,0,243,3341,400,49,-1,,7,3390,643
209,5,1,1,1,32,1,243,3341,247,49,96,Companies,7,3390,490
210,5,1,1,1,32,2,508,3341,135,39,96,House,7,3380,643
211,4,1,1,1,33,0,243,3404,267,51,-1,,7,3455,510
212,5,1,1,1,33,1,243,3404,147,41,95,Crown,7,3445,390
213,5,1,1,1,33,2,408,3406,102,49,96,Way,7,3455,510
214,4,1,1,1,34,0,243,3468,163,39,-1,,7,3507,406
215,5,1,1,1,34,1,243,3468,163,39,96,Cardiff,7,3507,406
216,4,1,1,1,35,0,243,3533,237,41,-1,,7,3574,480
217,5,1,1,1,35,1,243,3533,121,39,89,CF14,7,3572,364
218,5,1,1,1,35,2,382,3535,98,39,91,3UZ,7,3574,480
0,1,1,0,0,0,0,0,0,3106,3853,-1,,8,3853,3106
1,2,1,1,0,0,0,0,47,2836,1043,-1,,8,1090,2836
2,3,1,1,1,0,0,0,47,2836,1043,-1,,8,1090,2836
3,4,1,1,1,1,0,2210,47,625,47,-1,,8,94,2835
4,5,1,1,1,1,1,2210,47,226,37,91,Castlemore,8,84,2436
5,5,1,1,1,1,2,2454,49,141,45,96,Ranger,8,94,2595
6,5,1,1,1,1,3,2608,51,57,41,96,(3),8,92,2665
7,5,1,1,1,1,4,2682,51,153,35,58,Limited,8,86,2835
8,4,1,1,1,2,0,2014,110,822,45,-1,,8,155,2836
9,5,1,1,1,2,1,2014,110,179,35,95,Directors,8,145,2193
10,5,1,1,1,2,2,2221,118,117,37,95,report,8,155,2338
11,5,1,1,1,2,3,2354,112,69,35,96,and,8,147,2423
12,5,1,1,1,2,4,2441,110,169,37,93,financial,8,147,2610
13,5,1,1,1,2,5,2628,120,208,29,96,statements,8,149,2836
14,4,1,1,1,3,0,2065,167,769,47,-1,,8,214,2834
15,5,1,1,1,3,1,2065,167,69,35,96,For,8,202,2134
16,5,1,1,1,3,2,2149,167,54,35,96,the,8,202,2203
17,5,1,1,1,3,3,2215,179,83,33,96,year,8,212,2298
18,5,1,1,1,3,4,2312,169,118,35,96,ended,8,204,2430
19,5,1,1,1,3,5,2446,169,49,35,96,30,8,204,2495
20,5,1,1,1,3,6,2510,169,212,45,96,September,8,214,2722
21,5,1,1,1,3,7,2738,171,96,35,96,2007,8,206,2834
22,4,1,1,1,4,0,246,326,466,60,-1,,8,386,712
23,5,1,1,1,4,1,246,326,166,51,96,Notes,8,377,412
24,5,1,1,1,4,2,434,333,278,53,96,(continued),8,386,712
25,4,1,1,1,5,0,250,600,805,51,-1,,8,651,1055
26,5,1,1,1,5,1,250,600,44,39,96,13,8,639,294
27,5,1,1,1,5,2,440,600,202,39,96,Ultimate,8,639,642
28,5,1,1,1,5,3,657,600,257,51,96,controlling,8,651,914
29,5,1,1,1,5,4,930,604,125,45,96,party,8,649,1055
30,4,1,1,1,6,0,246,730,2580,55,-1,,8,785,2826
31,5,1,1,1,6,1,246,736,50,37,96,At,8,773,296
32,5,1,1,1,6,2,318,735,53,40,95,30,8,775,371
33,5,1,1,1,6,3,391,735,233,50,93,September,8,785,624
34,5,1,1,1,6,4,644,734,119,46,92,2007,8,780,763
35,5,1,1,1,6,5,787,735,64,40,97,the,8,775,851
36,5,1,1,1,6,6,871,742,165,31,96,trustees,8,773,1036
37,5,1,1,1,6,7,1057,734,47,37,96,of,8,771,1104
38,5,1,1,1,6,8,1120,745,22,26,96,a,8,771,1142
39,5,1,1,1,6,9,1163,734,229,39,96,Settlement,8,773,1392
40,5,1,1,1,6,10,1414,732,62,39,96,for,8,771,1476
41,5,1,1,1,6,11,1497,734,62,39,96,the,8,773,1559
42,5,1,1,1,6,12,1580,734,151,39,96,benefit,8,773,1731
43,5,1,1,1,6,13,1752,732,47,40,96,of,8,772,1799
44,5,1,1,1,6,14,1816,734,63,38,96,the,8,772,1879
45,5,1,1,1,6,15,1901,732,174,41,96,children,8,773,2075
46,5,1,1,1,6,16,2097,730,49,39,96,of,8,769,2146
47,5,1,1,1,6,17,2161,732,53,38,92,JG,8,770,2214
48,5,1,1,1,6,18,2234,732,210,49,91,Whateley,8,781,2444
49,5,1,1,1,6,19,2464,732,92,39,92,held,8,771,2556
50,5,1,1,1,6,20,2578,732,97,39,92,74,8,771,2675
51,5,1,1,1,6,21,2697,732,48,39,96,of,8,771,2745
52,5,1,1,1,6,22,2761,732,65,39,96,the,8,771,2826
53,4,1,1,1,7,0,246,796,2584,53,-1,,8,849,2830
54,5,1,1,1,7,1,246,799,111,38,96,share,8,837,357
55,5,1,1,1,7,2,377,798,143,51,96,capital,8,849,520
56,5,1,1,1,7,3,542,798,49,39,91,of,8,837,591
57,5,1,1,1,7,4,606,798,247,39,83,Castlemore,8,837,853
58,5,1,1,1,7,5,875,800,137,47,96,Group,8,847,1012
59,5,1,1,1,7,6,1036,798,196,49,95,Holdings,8,847,1232
60,5,1,1,1,7,7,1254,798,165,37,69,Limited,8,835,1419
61,5,1,1,1,7,8,1473,798,96,37,69,This,8,835,1569
62,5,1,1,1,7,9,1589,806,97,29,95,trust,8,835,1686
63,5,1,1,1,7,10,1708,810,79,27,95,was,8,837,1787
64,5,1,1,1,7,11,1806,796,243,39,96,established,8,835,2049
65,5,1,1,1,7,12,2069,796,55,49,96,by,8,845,2124
66,5,1,1,1,7,13,2144,796,62,38,96,Mr,8,834,2206
67,5,1,1,1,7,14,2222,796,59,38,93,JG,8,834,2281
68,5,1,1,1,7,15,2303,796,223,49,88,Whateley,8,845,2526
69,5,1,1,1,7,16,2548,808,23,27,95,a,8,835,2571
70,5,1,1,1,7,17,2589,796,174,39,92,director,8,835,2763
71,5,1,1,1,7,18,2783,796,47,39,96,of,8,835,2830
72,4,1,1,1,8,0,248,859,2564,55,-1,,8,914,2812
73,5,1,1,1,8,1,248,863,62,39,93,the,8,902,310
74,5,1,1,1,8,2,328,875,211,39,92,company,8,914,539
75,5,1,1,1,8,3,559,863,63,39,97,for,8,902,622
76,5,1,1,1,8,4,639,863,64,39,97,the,8,902,703
77,5,1,1,1,8,5,722,863,149,39,96,benefit,8,902,871
78,5,1,1,1,8,6,891,861,47,41,96,of,8,902,938
79,5,1,1,1,8,7,953,863,59,37,96,his,8,900,1012
80,5,1,1,1,8,8,1032,861,174,39,53,children,8,900,1206
81,5,1,1,1,8,9,1254,861,84,39,91,The,8,900,1338
82,5,1,1,1,8,10,1357,871,165,29,86,trustees,8,900,1522
83,5,1,1,1,8,11,1540,873,199,39,96,comprise,8,912,1739
84,5,1,1,1,8,12,1758,863,66,37,93,Mr,8,900,1824
85,5,1,1,1,8,13,1842,863,31,37,90,R,8,900,1873
86,5,1,1,1,8,14,1893,859,151,45,90,Lovell,8,904,2044
87,5,1,1,1,8,15,2063,861,69,37,93,Mr,8,898,2132
88,5,1,1,1,8,16,2148,861,32,37,91,R,8,898,2180
89,5,1,1,1,8,17,2197,859,215,39,50,Chiverrell,8,898,2412
90,5,1,1,1,8,18,2433,861,77,37,96,and,8,898,2510
91,5,1,1,1,8,19,2530,861,66,37,93,Mr,8,898,2596
92,5,1,1,1,8,20,2612,861,32,37,93,L,8,898,2644
93,5,1,1,1,8,21,2662,861,150,37,95,Nuttall,8,898,2812
94,4,1,1,1,9,0,0,926,1247,164,-1,,8,1090,1247
95,5,1,1,1,9,1,0,965,15,125,0,),8,1090,15
96,5,1,1,1,9,2,246,928,84,39,96,The,8,967,330
97,5,1,1,1,9,3,348,935,162,32,96,trustees,8,967,510
98,5,1,1,1,9,4,528,939,63,28,96,are,8,967,591
99,5,1,1,1,9,5,609,928,64,39,96,the,8,967,673
100,5,1,1,1,9,6,691,928,174,39,94,ultimate,8,967,865
101,5,1,1,1,9,7,883,926,239,51,96,controlling,8,977,1122
102,5,1,1,1,9,8,1138,934,109,43,96,party,8,977,1247
